year,state,district,dem,rep,tot,incumbent,prevparty,voteage_pop,voteage_m,voteage_f,race_pop,race_white,race_nonwhite,ed_pop,ed_4y,ed_no4y,age_pop,age_18_34,age_35_49,age_50_64,age_65_plus,inc_pop,inc_lt_50,inc_50_100,inc_100_plus,"Gender,Male","Gender,Female","Age,18-34","Age,35-49","Age,50-64","Age,65 and Older","Income,Less Than $50K","Income,$50-100K","Income,$100K or More","Race,White","Race,Non-White","Education,HS or less","Education,4yrDegree"
2012,AK,1,82927,185296,289804,1,r,260120,135526,124594,731449,486551,244898,464594,130124,334470,731449,148244,147769,145374,62119,251651,91790,83080,76781,-8,11,18,0,-4,-11,20,-6,-14,-20,53,3,1
2012,AL,1,0,196374,200676,1,r,362092,175695,186397,693136,470105,223031,464553,102793,361760,693136,112140,135318,138492,105175,268109,153452,76894,37763,-8,11,18,0,-4,-11,20,-6,-14,-20,76,3,0
2012,AL,2,103092,180591,283953,1,r,357776,173303,184473,683565,451176,232389,457256,98982,358274,683565,119711,132677,130170,101580,262364,153519,72418,36427,-8,11,18,0,-4,-11,20,-6,-14,-20,77,3,0
2012,AL,3,98141,175306,273930,1,r,342806,167660,175146,696249,489433,206816,454783,91989,362794,696249,122953,136201,134675,97461,269516,158290,76330,34896,-8,11,18,0,-4,-11,20,-6,-14,-20,77,3,1
2012,AL,4,69706,199071,269118,1,r,370119,180295,189824,680966,598955,82011,460982,70187,390795,680966,99916,134584,137509,112010,258068,160685,69544,27839,-8,11,18,0,-4,-11,20,-6,-14,-20,64,3,1
2012,AL,5,101772,189185,291293,1,r,293980,144181,149799,696690,536553,160137,470908,141852,329056,696690,118376,143167,140862,98944,269229,133861,80871,54497,-8,11,18,0,-4,-11,20,-6,-14,-20,71,3,0
2012,AL,6,88267,219262,308102,1,r,361138,175617,185521,688675,553061,135614,469710,159612,310098,688675,115768,145675,136201,95172,261687,117621,83652,60414,-8,11,18,0,-4,-11,20,-6,-14,-20,68,3,1
2012,AL,7,232520,73835,306558,1,d,356749,167224,189525,682742,234088,448654,431454,81744,349710,682742,120014,123905,131004,90017,256196,176454,55866,23876,-8,11,18,0,-4,-11,20,-6,-14,-20,80,3,0
2012,AR,1,96601,138800,246843,0,r,347408,172673,174735,729169,573558,155611,492227,74265,417962,729169,117900,139392,141855,121147,281235,179843,73926,27466,-8,11,18,0,-4,-11,20,-6,-14,-20,76,3,0
2012,AR,2,113156,158175,286598,1,r,351696,170936,180760,747332,552404,194928,491727,139259,352468,747332,141541,146505,140451,100597,290724,155842,86705,48177,-8,11,18,0,-4,-11,20,-6,-14,-20,73,3,0
2012,AR,3,0,186467,245660,1,r,399685,196896,202789,754704,646773,107931,483354,115697,367657,754704,137276,147597,132097,97561,287546,165534,80198,41814,-8,11,18,0,-4,-11,20,-6,-14,-20,47,3,0
2012,AR,4,95013,154149,258953,0,d,389593,190924,198669,717926,535216,182710,482074,79888,402186,717926,104050,133358,147605,121802,284354,180096,75581,28677,-8,11,18,0,-4,-11,20,-6,-14,-20,72,3,0
2012,AZ,1,122774,113594,251595,0,r,305992,155250,150742,722706,466617,256089,460279,106634,353645,722706,120962,130704,136938,103571,239811,128487,74268,37056,-8,11,18,0,-4,-11,20,-6,-14,-20,44,3,1
2012,AZ,2,147338,144884,292279,0,r,311096,154919,156177,727099,587594,139505,506731,163340,343391,727099,128449,133920,140616,135867,300327,159469,88219,52639,-8,11,18,0,-4,-11,20,-6,-14,-20,46,3,2
2012,AZ,3,98468,62663,168698,0,r,301163,148574,152589,719765,524877,194888,411801,64637,347164,719765,140455,129029,112341,67524,225120,134907,66339,23874,-8,11,18,0,-4,-11,20,-6,-14,-20,41,3,0
2012,AZ,4,69154,162907,243760,0,d,350988,177712,173276,720881,630472,90409,518803,96786,422017,720881,98915,120487,151004,173035,284045,163981,84210,35854,-8,11,18,0,-4,-11,20,-6,-14,-20,43,3,0
2012,AZ,5,89589,183470,273059,0,r,271523,132260,139263,737326,635666,101660,486159,160363,325796,737326,112562,148704,131229,115378,262874,103100,87708,72066,-8,11,18,0,-4,-11,20,-6,-14,-20,45,3,0
2012,AZ,6,97666,179706,293177,0,r,299305,148215,151090,722561,621351,101210,508381,211001,297380,722561,128433,151026,150469,111408,296486,126930,86859,82697,-8,11,18,0,-4,-11,20,-6,-14,-20,46,3,1
2012,AZ,7,104489,0,127827,0,d,393793,198709,195084,735599,506305,229294,416310,59705,356605,735599,149774,151345,103345,47585,221027,152326,48922,19779,-8,11,18,0,-4,-11,20,-6,-14,-20,44,3,0
2012,AZ,8,95635,172809,272791,0,d,231166,112247,118919,730846,624989,105857,496758,137548,359210,730846,100508,141303,131646,142358,271067,119471,91539,60057,-8,11,18,0,-4,-11,20,-6,-14,-20,48,3,0
2012,AZ,9,121881,111630,250131,0,,344322,172436,171886,736472,566328,170144,475242,170572,304670,736472,183312,142705,126647,74360,291411,148480,86138,56793,-8,11,18,0,-4,-11,20,-6,-14,-20,46,3,1
2012,CA,1,125386,168827,294213,0,d,262525,132757,129768,711354,620859,90495,488713,107195,381518,711354,114330,124567,156268,128336,273025,149026,78655,45344,-8,11,18,0,-4,-11,20,-6,-14,-20,45,3,0
2012,CA,10,98934,110265,209199,0,d,294542,145933,148609,713348,526630,186718,444010,74531,369479,713348,126389,142690,124630,80305,225928,113213,66213,46502,-8,11,18,0,-4,-11,20,-6,-14,-20,42,3,0
2012,CA,11,200743,87136,287879,0,d,278007,135982,142025,726253,469187,257066,494136,205089,289047,726253,120663,149391,147745,105029,263384,93880,75048,94456,-8,11,18,0,-4,-11,20,-6,-14,-20,50,3,1
2012,CA,12,253709,44478,298187,0,d,265714,135855,129859,717042,371702,345340,568665,313551,255114,717042,200267,167311,134247,100258,313416,117943,73960,121513,-8,11,18,0,-4,-11,20,-6,-14,-20,49,3,1
2012,CA,13,250436,0,288582,0,d,294748,144298,150450,719569,331694,387875,493727,221836,271891,719569,155209,155911,135338,86003,279932,126321,75175,78436,-8,11,18,0,-4,-11,20,-6,-14,-20,54,3,2
2012,CA,14,203828,54455,258283,0,d,246984,121761,125223,725771,361692,364079,513735,212393,301342,725771,126509,163047,148566,102358,248922,79723,71795,97404,-8,11,18,0,-4,-11,20,-6,-14,-20,45,3,1
2012,CA,15,231034,0,231034,0,d,232956,113909,119047,732515,365847,366668,494154,202562,291592,732515,127296,166050,142953,84329,239872,68519,64161,107192,-8,11,18,0,-4,-11,20,-6,-14,-20,49,3,0
2012,CA,16,84649,62801,147450,0,d,343962,170535,173427,716746,385426,331320,408758,45392,363366,716746,140439,129904,106976,65595,202894,128445,52090,22359,-8,11,18,0,-4,-11,20,-6,-14,-20,43,3,-1
2012,CA,17,159392,57336,216728,0,d,258716,130421,128295,719276,242214,477062,495849,258247,237602,719276,140766,173613,126598,78607,238752,58645,58699,121408,-8,11,18,0,-4,-11,20,-6,-14,-20,47,3,2
2012,CA,18,212831,89103,301934,0,d,287562,143479,144083,736397,502414,233983,511046,297247,213799,736397,122148,162346,149397,100819,272803,70753,63642,138408,-8,11,18,0,-4,-11,20,-6,-14,-20,45,3,3
2012,CA,19,162300,59313,221613,0,r,248076,123910,124166,712983,358326,354657,466318,149076,317242,712983,141259,155177,128296,74218,215927,74862,60171,80894,-8,11,18,0,-4,-11,20,-6,-14,-20,44,3,0
2012,CA,2,226216,91310,317526,0,r,309854,153396,156458,704148,566582,137566,500996,194658,306338,704148,97509,141840,162231,119806,276990,117786,75974,83230,-8,11,18,0,-4,-11,20,-6,-14,-20,44,3,1
2012,CA,20,172996,60566,233562,0,d,375729,191436,184293,721890,555539,166351,449034,123030,326004,721890,136949,137903,128607,81372,220555,91112,70890,58553,-8,11,18,0,-4,-11,20,-6,-14,-20,41,3,1
2012,CA,21,49119,67164,116283,0,r,371020,197585,173435,712866,471144,241722,399986,30965,369021,712866,149406,133806,99038,56866,179764,117146,44917,17701,-8,11,18,0,-4,-11,20,-6,-14,-20,41,3,-1
2012,CA,22,81555,132386,213941,0,r,319016,157903,161113,717545,517179,200366,427979,100893,327086,717545,137203,131377,113796,78448,231140,115396,66407,49337,-8,11,18,0,-4,-11,20,-6,-14,-20,42,3,0
2012,CA,23,0,158161,216003,0,d,284549,144554,139995,713959,533668,180291,441804,84051,357753,713959,130569,137839,127173,81263,233228,110527,72463,50238,-8,11,18,0,-4,-11,20,-6,-14,-20,45,3,0
2012,CA,24,156749,127746,284495,0,r,356655,179342,177313,716974,559594,157380,455051,143389,311662,716974,135433,126675,132844,103682,248108,103891,77192,67025,-8,11,18,0,-4,-11,20,-6,-14,-20,41,3,1
2012,CA,25,106982,129593,236575,0,r,245114,123566,121548,717685,464699,252986,440967,123631,317336,717685,112045,154782,132637,68511,218307,79776,67783,70748,-8,11,18,0,-4,-11,20,-6,-14,-20,46,3,0
2012,CA,26,139072,124863,263935,0,r,303378,150649,152729,711999,554789,157210,459808,143612,316196,711999,124109,141713,134896,92307,224847,77997,73090,73760,-8,11,18,0,-4,-11,20,-6,-14,-20,41,3,1
2012,CA,27,154191,86817,241008,0,d,214206,104045,110161,710190,316863,393327,505893,205746,300147,710190,131599,148711,150687,109035,243811,95542,69975,78294,-8,11,18,0,-4,-11,20,-6,-14,-20,46,3,1
2012,CA,28,188703,58008,246711,0,d,250648,126692,123956,727828,495526,232302,533789,219951,313838,727828,166828,165531,137263,99967,293413,139624,76793,76996,-8,11,18,0,-4,-11,20,-6,-14,-20,44,3,0
2012,CA,29,111287,0,150281,0,d,296262,148349,147913,722810,449952,272858,453288,91995,361293,722810,156711,150093,115764,66744,202011,111429,58787,31795,-8,11,18,0,-4,-11,20,-6,-14,-20,41,3,-2
2012,CA,3,126882,107086,233968,0,r,281080,141114,139966,712075,468948,243127,445983,106344,339639,712075,132977,135255,134098,82660,240968,113725,73461,53782,-8,11,18,0,-4,-11,20,-6,-14,-20,47,3,1
2012,CA,30,247851,0,247851,0,d,244171,119367,124804,729053,491626,237427,507614,214884,292730,729053,133074,164997,141552,98298,266007,102088,78342,85577,-8,11,18,0,-4,-11,20,-6,-14,-20,46,3,0
2012,CA,31,0,161219,161219,0,d,271801,134246,137555,724413,437402,287011,433224,96757,336467,724413,141687,143632,118077,66524,209465,99746,65357,44362,-8,11,18,0,-4,-11,20,-6,-14,-20,46,3,1
2012,CA,32,124903,65208,190111,0,d,270592,132746,137846,718635,369434,349201,458498,89535,368963,718635,140991,144644,126411,82325,192970,83154,65745,44071,-8,11,18,0,-4,-11,20,-6,-14,-20,42,3,0
2012,CA,33,171860,0,318520,0,d,230688,111615,119073,701029,535436,165593,499996,306369,193627,701029,116559,154121,144811,109074,291359,82883,70587,137889,-8,11,18,0,-4,-11,20,-6,-14,-20,48,3,2
2012,CA,34,120367,20223,140590,0,d,353832,181620,172212,708100,240547,467553,473016,103710,369306,708100,170449,149314,120208,72309,237541,157748,53228,26565,-8,11,18,0,-4,-11,20,-6,-14,-20,42,3,-1
2012,CA,35,142680,0,142680,0,d,311060,154765,156295,718067,410225,307842,426346,58900,367446,718067,153354,141558,114632,53967,183023,87330,64038,31655,-8,11,18,0,-4,-11,20,-6,-14,-20,42,3,-2
2012,CA,36,110189,97953,208142,0,d,325994,164775,161219,714975,462849,252126,475016,96695,378321,714975,108976,126002,128342,135311,250613,142149,66277,42187,-8,11,18,0,-4,-11,20,-6,-14,-20,43,3,1
2012,CA,37,207039,32541,239580,0,d,328318,158250,170068,716299,280913,435386,488590,178648,309942,716299,166984,153527,124323,84935,272662,139915,72989,59758,-8,11,18,0,-4,-11,20,-6,-14,-20,56,3,1
2012,CA,38,145280,69807,215087,0,d,237430,115692,121738,715745,400795,314950,461112,100831,360281,715745,135514,145865,130695,87347,203928,84635,67133,52160,-8,11,18,0,-4,-11,20,-6,-14,-20,42,3,0
2012,CA,39,106360,145607,251967,0,d,242357,119622,122735,718996,390410,328586,483562,188373,295189,718996,135997,149435,144406,91911,222106,73088,71065,77953,-8,11,18,0,-4,-11,20,-6,-14,-20,44,3,0
2012,CA,4,125885,197803,323688,1,r,251883,126765,125118,704230,600122,104108,500209,151755,348454,704230,94621,139667,158986,128208,263710,107484,82282,73944,-8,11,18,0,-4,-11,20,-6,-14,-20,45,3,0
2012,CA,40,125553,0,125553,0,r,324877,159354,165523,694514,373645,320869,399124,36594,362530,694514,142265,138891,95947,55372,172821,109711,46087,17023,-8,11,18,0,-4,-11,20,-6,-14,-20,40,3,-2
2012,CA,41,103578,72074,175652,0,r,321391,159254,162137,726487,431902,294585,423304,72467,350837,726487,150730,140499,113121,62038,195850,97668,61491,36691,-8,11,18,0,-4,-11,20,-6,-14,-20,45,3,1
2012,CA,42,84702,130245,214947,0,r,245367,121384,123983,745833,532828,213005,458885,103216,355669,745833,122651,160098,126431,78035,215114,79007,75668,60439,-8,11,18,0,-4,-11,20,-6,-14,-20,45,3,0
2012,CA,43,200894,0,200894,0,d,302761,147896,154865,697985,255509,442476,450623,108417,342206,697985,140543,147545,116845,75660,233691,126272,65059,42360,-8,11,18,0,-4,-11,20,-6,-14,-20,52,3,0
2012,CA,44,165898,0,165898,0,r,295776,144245,151531,714989,298270,416719,408491,46726,361765,714989,139651,142781,105151,60244,182199,100899,53601,27699,-8,11,18,0,-4,-11,20,-6,-14,-20,46,3,-2
2012,CA,45,121814,171417,293231,0,r,229413,112986,116427,724219,465988,258231,485734,253084,232650,724219,118056,162575,140952,91787,253921,67300,72021,114600,-8,11,18,0,-4,-11,20,-6,-14,-20,45,3,1
2012,CA,46,95694,54121,149815,0,r,338038,168971,169067,717993,432443,285550,426508,71592,354916,717993,154431,151074,104566,57305,181566,86411,59349,35806,-8,11,18,0,-4,-11,20,-6,-14,-20,40,3,-1
2012,CA,47,130093,99919,230012,0,d,270694,132844,137850,722624,405090,317534,473451,144955,328496,722624,133358,154523,134659,85537,246195,113144,72746,60305,-8,11,18,0,-4,-11,20,-6,-14,-20,48,3,0
2012,CA,48,113358,177144,290502,0,r,214138,106115,108023,717809,494190,223619,506949,218539,288410,717809,131773,152866,147199,107211,261678,84191,74518,102969,-8,11,18,0,-4,-11,20,-6,-14,-20,44,3,0
2012,CA,49,114893,159725,274618,1,r,304508,153916,150592,714647,549135,165512,472880,190959,281921,714647,133684,145172,135953,93140,247703,91603,68736,87364,-8,11,18,0,-4,-11,20,-6,-14,-20,43,3,1
2012,CA,5,202872,69545,272417,0,d,322316,157294,165022,715809,488255,227554,490862,143135,347727,715809,127625,138398,151801,105408,255226,105881,79757,69588,-8,11,18,0,-4,-11,20,-6,-14,-20,48,3,0
2012,CA,50,83455,174838,258293,0,r,312171,151783,160388,721337,581165,140172,467845,118007,349838,721337,120385,144073,140245,91358,240266,107694,73861,58711,-8,11,18,0,-4,-11,20,-6,-14,-20,44,3,0
2012,CA,51,113934,45464,159398,0,d,301176,153748,147428,738513,481102,257411,436667,55552,381115,738513,152013,141890,117480,70561,196644,118310,54335,23999,-8,11,18,0,-4,-11,20,-6,-14,-20,43,3,-1
2012,CA,52,151451,144459,295910,0,r,244264,122565,121699,704272,488857,215415,487394,273344,214050,704272,163477,146635,129737,90110,268528,82810,77776,107942,-8,11,18,0,-4,-11,20,-6,-14,-20,48,3,2
2012,CA,53,164825,103482,268307,1,d,253621,128521,125100,725892,476957,248935,483038,166373,316665,725892,167576,147891,121743,84334,258604,110495,83350,64759,-8,11,18,0,-4,-11,20,-6,-14,-20,48,3,0
2012,CA,6,160667,53406,214073,0,d,256891,125112,131779,714536,382125,332411,458231,116014,342217,714536,159679,139395,123739,79061,261139,139035,77084,45020,-8,11,18,0,-4,-11,20,-6,-14,-20,52,3,0
2012,CA,7,141241,132050,273291,0,d,230900,114009,116891,719962,465443,254519,477393,148851,328542,719962,122073,149033,137549,93676,253645,104326,79131,70188,-8,11,18,0,-4,-11,20,-6,-14,-20,51,3,0
2012,CA,8,0,179644,179644,0,d,284543,142025,142518,708578,510793,197785,430151,62336,367815,708578,118715,134077,124450,83352,222911,125509,63172,34230,-8,11,18,0,-4,-11,20,-6,-14,-20,48,3,1
2012,CA,9,118373,94704,213077,0,d,265099,130880,134219,724666,404615,320051,441382,88527,352855,724666,120603,143411,126867,78477,223576,105209,67138,51229,-8,11,18,0,-4,-11,20,-6,-14,-20,47,3,-1
2012,CO,1,237579,93217,348210,1,d,384109,191784,192325,750153,581901,168252,519119,230695,288424,750153,186350,157102,131676,78997,318312,152273,92358,73681,-8,11,18,0,-4,-11,20,-6,-14,-20,49,3,1
2012,CO,2,234758,162639,421580,1,d,311712,155468,156244,743592,672359,71233,494642,259212,235430,743592,139929,150742,158218,87715,297209,115211,88278,93720,-8,11,18,0,-4,-11,20,-6,-14,-20,44,3,1
2012,CO,3,142619,185291,347247,0,r,374963,189357,185606,720338,630284,90054,489147,142127,347020,720338,114230,139737,152658,108257,285443,152012,88476,44955,-8,11,18,0,-4,-11,20,-6,-14,-20,40,3,0
2012,CO,4,125800,200006,342336,1,r,360824,182581,178243,738491,655012,83479,475118,153424,321694,738491,114918,158093,140738,84585,265749,110668,85970,69111,-8,11,18,0,-4,-11,20,-6,-14,-20,42,3,0
2012,CO,5,0,199639,307231,1,r,279107,141770,137337,740514,614930,125584,481500,160052,321448,740514,143439,144832,142205,86106,275383,126139,88272,60972,-8,11,18,0,-4,-11,20,-6,-14,-20,52,3,1
2012,CO,6,156937,163938,342914,1,r,312872,154905,157967,748467,570255,178212,487790,193764,294026,748467,131372,163487,140674,77034,272236,102970,89457,79809,-8,11,18,0,-4,-11,20,-6,-14,-20,52,3,0
2012,CO,7,182460,139066,340970,1,d,347788,173322,174466,746027,651932,94095,497338,151732,345606,746027,145319,157570,139414,88245,281756,119397,99376,62983,-8,11,18,0,-4,-11,20,-6,-14,-20,41,3,0
2012,CT,1,192840,82321,297061,1,d,267857,130154,137703,723908,526395,197513,502674,173399,329275,723908,116151,147717,152745,111090,283536,113079,89021,81436,-8,11,18,0,-4,-11,20,-6,-14,-20,59,3,2
2012,CT,2,189444,88103,298960,0,d,263771,131694,132077,709756,623903,85853,484490,164428,320062,709756,105349,146644,152486,107711,267233,94980,85789,86464,-8,11,18,0,-4,-11,20,-6,-14,-20,54,3,2
2012,CT,3,197163,73726,291301,1,d,287219,137564,149655,712314,535449,176865,493981,169485,324496,712314,123508,143472,149752,104888,278565,117932,83219,77414,-8,11,18,0,-4,-11,20,-6,-14,-20,59,3,2
2012,CT,4,167320,117503,293432,1,d,325489,158372,167117,728616,538426,190190,485963,238913,247050,728616,104857,155236,145749,101106,258504,81775,63869,112860,-8,11,18,0,-4,-11,20,-6,-14,-20,55,3,2
2012,CT,5,137631,128927,284757,0,d,294903,143386,151517,715753,580799,134954,490870,164912,325958,715753,106578,148497,151044,107229,269974,107410,80024,82540,-8,11,18,0,-4,-11,20,-6,-14,-20,51,3,2
2012,DC,1,0,0,0,0,,312677,147870,164807,632323,250657,381666,439531,232791,206740,632323,174630,123410,105342,71901,266662,108394,63095,95173,-8,11,18,0,-4,-11,20,-6,-14,-20,73,3,4
2012,DE,1,249933,129757,388059,1,d,362496,175772,186724,917092,639294,277798,618612,182689,435923,917092,150322,179078,184872,140813,340308,145136,112988,82184,-8,11,18,0,-4,-11,20,-6,-14,-20,68,3,1
2012,FL,1,92961,238440,342594,1,r,263826,132578,131248,721000,557371,163629,486991,122902,364089,721000,129149,138586,144612,106552,274901,138050,92208,44643,-8,11,18,0,-4,-11,20,-6,-14,-20,67,3,0
2012,FL,10,153574,164649,318269,0,r,286942,139283,147659,721521,557334,164187,507230,141689,365541,721521,123568,145652,135929,128447,274774,144578,81625,48571,-8,11,18,0,-4,-11,20,-6,-14,-20,56,3,0
2012,FL,11,120303,218360,338663,0,d,210159,102061,108098,705020,614056,90964,540056,95682,444374,705020,77394,109414,148933,222980,290543,181786,81105,27652,-8,11,18,0,-4,-11,20,-6,-14,-20,60,3,0
2012,FL,12,108770,209604,330167,0,r,232511,111755,120756,695511,615889,79622,506759,142951,363808,695511,88480,141166,150669,146741,273360,142534,78329,52497,-8,11,18,0,-4,-11,20,-6,-14,-20,51,3,0
2012,FL,13,139742,189605,329347,0,r,267094,128560,138534,701546,611070,90476,532262,147917,384345,701546,105644,132745,157281,160136,312377,172196,87788,52393,-8,11,18,0,-4,-11,20,-6,-14,-20,55,3,0
2012,FL,14,197121,83480,280601,0,r,312503,154735,157768,739489,472627,266862,492590,125851,366739,739489,158069,151905,135718,83227,285409,173584,71650,40175,-8,11,18,0,-4,-11,20,-6,-14,-20,59,3,0
2012,FL,15,0,1,1,0,r,264256,127115,137141,702728,544054,158674,461316,127349,333967,702728,118181,140800,137087,97216,253920,130820,78199,44901,-8,11,18,0,-4,-11,20,-6,-14,-20,57,3,0
2012,FL,16,161929,187147,349076,0,r,301452,144363,157089,714190,631393,82797,541211,160134,381077,714190,85342,119419,151268,206971,301484,156160,91600,53724,-8,11,18,0,-4,-11,20,-6,-14,-20,54,3,1
2012,FL,17,116766,165488,282266,0,d,326195,161861,164334,711198,607161,104037,511515,94161,417354,711198,88093,122925,138781,183775,266228,152355,81195,32678,-8,11,18,0,-4,-11,20,-6,-14,-20,53,3,0
2012,FL,18,166257,164353,330665,0,r,277981,134742,143239,710837,575821,135016,521164,157058,364106,710837,97212,134760,149087,164226,281363,139696,79088,62579,-8,11,18,0,-4,-11,20,-6,-14,-20,58,3,1
2012,FL,19,109746,189833,306216,0,d,337353,165113,172240,722151,621818,100333,540578,155282,385296,722151,92331,122076,148528,198893,283141,142759,85084,55298,-8,11,18,0,-4,-11,20,-6,-14,-20,52,3,1
2012,FL,2,157634,175856,333718,0,r,299949,151012,148937,707654,488507,219147,461943,126506,335437,707654,142910,135732,135831,95501,264243,149154,76642,38447,-8,11,18,0,-4,-11,20,-6,-14,-20,73,3,1
2012,FL,20,214727,0,244285,0,d,302837,147625,155212,730502,284808,445694,484985,82357,402628,730502,143569,147213,131163,98620,246669,159916,63453,23300,-8,11,18,0,-4,-11,20,-6,-14,-20,70,3,0
2012,FL,21,221263,0,284400,0,r,254522,122373,132149,717852,570569,147283,509662,180944,328718,717852,98223,139052,137721,159913,269288,122560,80338,66390,-8,11,18,0,-4,-11,20,-6,-14,-20,54,3,0
2012,FL,22,171021,142050,313071,0,r,312089,155378,156711,702250,571528,130722,525450,190412,335038,702250,115275,137445,146617,148852,299687,143472,85138,71077,-8,11,18,0,-4,-11,20,-6,-14,-20,54,3,1
2012,FL,23,174205,98096,275430,0,d,261914,126784,135130,729345,552890,176455,519151,190477,328674,729345,115662,165084,149099,114888,281081,137194,74574,69313,-8,11,18,0,-4,-11,20,-6,-14,-20,49,3,1
2012,FL,24,1,0,1,0,r,264447,126161,138286,725188,281513,443675,477822,98129,379693,725188,152909,154812,128399,77867,232332,146008,59288,27036,-8,11,18,0,-4,-11,20,-6,-14,-20,66,3,0
2012,FL,25,0,151466,200229,0,r,267850,129733,138117,716312,625765,90547,486108,117571,368537,716312,116906,158022,130852,107688,213385,112709,64700,35976,-8,11,18,0,-4,-11,20,-6,-14,-20,42,3,-1
2012,FL,26,135694,108820,252957,0,,242129,118540,123589,726532,618514,108018,508750,142374,366376,726532,135434,156644,147465,107112,221191,110436,66983,43772,-8,11,18,0,-4,-11,20,-6,-14,-20,44,3,0
2012,FL,27,85020,138488,230171,0,,281966,139069,142897,726678,635134,91544,513159,153042,360117,726678,123127,156368,140886,122211,248149,143497,54462,50190,-8,11,18,0,-4,-11,20,-6,-14,-20,43,3,1
2012,FL,3,102468,204331,315669,0,d,292575,146404,146171,702872,554499,148373,461588,111683,349905,702872,127528,128113,136027,110055,252817,146876,69334,36607,-8,11,18,0,-4,-11,20,-6,-14,-20,63,3,1
2012,FL,4,0,239988,315470,1,r,273878,134858,139020,706401,548004,158397,485059,141070,343989,706401,141087,143186,142433,92363,264165,125847,84955,53363,-8,11,18,0,-4,-11,20,-6,-14,-20,63,3,0
2012,FL,5,190472,70700,269153,0,r,303626,146105,157521,710781,276079,434702,449917,68530,381387,710781,139193,141022,128558,79442,245010,170553,56050,18407,-8,11,18,0,-4,-11,20,-6,-14,-20,73,3,-1
2012,FL,6,146489,195962,342451,0,r,227981,110155,117826,711266,592847,118419,514624,142955,371669,711266,89435,130201,158062,158161,281866,157273,77061,47532,-8,11,18,0,-4,-11,20,-6,-14,-20,63,3,0
2012,FL,7,130479,185518,316010,1,r,222402,109182,113220,720817,590909,129908,479301,156446,322855,720817,135388,144209,141910,95389,254413,122619,78839,52955,-8,11,18,0,-4,-11,20,-6,-14,-20,52,3,0
2012,FL,8,130870,205432,348909,0,r,238855,116554,122301,703604,588973,114631,513991,136807,377184,703604,93365,127120,155938,159579,282122,153610,80522,47990,-8,11,18,0,-4,-11,20,-6,-14,-20,60,3,1
2012,FL,9,164891,98856,263747,0,r,284716,142424,142292,734323,553383,180940,470565,112790,357775,734323,150649,155060,126305,82022,244025,139103,74533,30389,-8,11,18,0,-4,-11,20,-6,-14,-20,47,3,0
2012,GA,1,92399,157181,249580,1,r,328788,161887,166901,714669,453912,260757,454731,107363,347368,714669,139518,135760,127253,88149,258163,143317,75650,39196,-8,11,18,0,-4,-11,20,-6,-14,-20,73,3,1
2012,GA,10,0,211065,211065,1,r,327664,159153,168511,708026,492873,215153,445032,103775,341257,708026,120792,138091,130482,88906,239862,129645,69810,40407,-8,11,18,0,-4,-11,20,-6,-14,-20,72,3,1
2012,GA,11,90353,196968,287321,1,r,322245,159370,162875,708052,533677,174375,462708,176027,286681,708052,129443,163170,129559,70319,262163,106535,84428,71200,-8,11,18,0,-4,-11,20,-6,-14,-20,62,3,0
2012,GA,12,139148,119973,259121,1,d,311822,155098,156724,701142,419866,281276,444673,89718,354955,701142,129661,132798,127818,86965,249417,148701,68555,32161,-8,11,18,0,-4,-11,20,-6,-14,-20,75,3,1
2012,GA,13,201988,79550,281538,1,d,319114,150447,168667,707070,249382,457688,450422,125544,324878,707070,120493,158835,128332,66288,240494,122844,76420,41230,-8,11,18,0,-4,-11,20,-6,-14,-20,74,3,0
2012,GA,14,59245,159947,219192,0,,362533,178785,183748,692581,595093,97488,449724,70383,379341,692581,108664,146697,128463,88844,243283,142724,70447,30112,-8,11,18,0,-4,-11,20,-6,-14,-20,58,3,1
2012,GA,2,162751,92410,255161,1,d,335687,163799,171888,693841,299910,393931,441785,72818,368967,693841,115619,130275,131695,89878,251461,164660,63211,23590,-8,11,18,0,-4,-11,20,-6,-14,-20,79,3,1
2012,GA,3,0,232380,232380,1,r,307492,148213,159279,704557,500337,204220,460757,111212,349545,704557,112843,146717,138647,90456,250868,122375,79270,49223,-8,11,18,0,-4,-11,20,-6,-14,-20,72,3,1
2012,GA,4,208861,75041,283902,0,d,311993,146475,165518,714225,223432,490793,449767,128890,320877,714225,118353,156808,133533,67372,245230,130995,75690,38545,-8,11,18,0,-4,-11,20,-6,-14,-20,75,3,1
2012,GA,5,234330,43335,277665,1,d,403124,198013,205111,731123,237151,493972,479288,184088,295200,731123,181993,155833,119086,65066,282775,158163,69770,54842,-8,11,18,0,-4,-11,20,-6,-14,-20,76,3,2
2012,GA,6,104365,189669,294034,1,r,337377,166940,170437,716576,512315,204261,484813,281175,203638,716576,126860,166338,138173,74385,268817,88593,77325,102899,-8,11,18,0,-4,-11,20,-6,-14,-20,57,3,1
2012,GA,7,95377,156689,252066,1,r,295805,147196,148609,716539,411591,304948,455515,173002,282513,716539,120303,177175,125630,58203,232974,92760,71675,68539,-8,11,18,0,-4,-11,20,-6,-14,-20,57,3,0
2012,GA,8,0,197789,197789,1,r,322373,159047,163326,705710,452548,253162,451751,87882,363869,705710,126950,136354,129718,93129,253345,149097,69149,35099,-8,11,18,0,-4,-11,20,-6,-14,-20,74,3,1
2012,GA,9,60052,192101,252153,0,r,399285,197734,201551,705834,610759,95075,472872,95398,377474,705834,108070,141631,139701,111396,254056,142451,75104,36501,-8,11,18,0,-4,-11,20,-6,-14,-20,54,3,0
2012,HI,1,116505,96824,217876,0,d,241263,121663,119600,692981,129102,563879,483888,164526,319362,692981,133298,138723,131567,113346,228099,80006,76155,71938,-8,11,18,0,-4,-11,20,-6,-14,-20,48,3,0
2012,HI,2,168503,40707,219283,0,d,244451,122952,121499,699332,218150,481182,468393,121690,346703,699332,132750,129267,142991,97077,219649,87675,73401,58573,-8,11,18,0,-4,-11,20,-6,-14,-20,47,3,0
2012,IA,1,222422,162465,390849,1,d,344180,170338,173842,766320,707238,59082,507313,128637,378676,766320,129174,140326,152293,121290,302029,142708,107601,51720,-8,11,18,0,-4,-11,20,-6,-14,-20,60,3,0
2012,IA,2,211863,161977,381275,1,d,389049,193217,195832,769399,702850,66549,511253,138021,373232,769399,131698,143735,153610,115800,309724,158075,98365,53284,-8,11,18,0,-4,-11,20,-6,-14,-20,57,3,1
2012,IA,3,168632,202000,386842,1,d,338837,166618,172219,779001,698166,80835,516110,161556,354554,779001,138066,156086,147999,101495,307376,135152,106668,65556,-8,11,18,0,-4,-11,20,-6,-14,-20,55,3,-1
2012,IA,4,169470,200063,377883,0,r,375634,187786,187848,759466,709693,49773,502317,108106,394211,759466,120814,132394,151298,131033,307919,163330,100501,44088,-8,11,18,0,-4,-11,20,-6,-14,-20,48,3,-1
2012,ID,1,97450,199402,316724,0,r,321836,161493,160343,801178,743291,57887,519374,123950,395424,801178,129774,154990,152547,112969,290844,155687,93889,41268,-8,11,18,0,-4,-11,20,-6,-14,-20,42,3,0
2012,ID,2,110847,207412,318494,1,r,380776,190108,190668,794550,715080,79470,493412,133943,359469,794550,148635,142586,141201,98063,292262,159396,90437,42429,-8,11,18,0,-4,-11,20,-6,-14,-20,42,3,0
2012,IL,1,236854,83989,320844,1,d,268568,125910,142658,709052,287682,421370,467045,122833,344212,709052,117574,138004,137843,100258,262145,140058,70875,51212,-8,11,18,0,-4,-11,20,-6,-14,-20,76,3,1
2012,IL,10,133890,130564,264454,0,r,267318,132651,134667,709209,554691,154518,462589,195302,267287,709209,110324,148308,136369,90037,245563,91454,72616,81493,-8,11,18,0,-4,-11,20,-6,-14,-20,48,3,1
2012,IL,11,148928,105348,254295,0,r,294083,146516,147567,722173,479400,242773,457633,155985,301648,722173,127706,155804,128442,72497,244110,91820,85054,67236,-8,11,18,0,-4,-11,20,-6,-14,-20,51,3,0
2012,IL,12,157000,129902,303949,0,d,294573,146153,148420,707195,560562,146633,473297,102184,371113,707195,122313,136064,141134,106317,273548,153157,80024,40367,-8,11,18,0,-4,-11,20,-6,-14,-20,74,3,0
2012,IL,13,136032,137034,294385,0,r,345916,170548,175368,710784,584746,126038,454090,131403,322687,710784,134865,125939,134639,102844,284018,151054,87253,45711,-8,11,18,0,-4,-11,20,-6,-14,-20,68,3,1
2012,IL,14,124351,177603,301954,0,r,247416,122962,124454,721774,633360,88414,465078,179487,285591,721774,96349,169642,142644,74083,245734,70503,82606,92625,-8,11,18,0,-4,-11,20,-6,-14,-20,49,3,0
2012,IL,15,94162,205775,299937,0,r,310863,154537,156326,712171,659530,52641,483872,86423,397449,712171,112400,136320,144903,117835,276412,148560,85927,41925,-8,11,18,0,-4,-11,20,-6,-14,-20,67,3,0
2012,IL,16,112301,181789,294090,0,r,284702,140226,144476,706170,637721,68449,474494,97395,377099,706170,112612,139515,142443,108606,267147,124197,92330,50620,-8,11,18,0,-4,-11,20,-6,-14,-20,53,3,0
2012,IL,17,153519,134623,288161,0,r,325445,160328,165117,703477,580899,122578,477088,80823,396265,703477,116091,131499,142805,117131,287465,162308,88357,36800,-8,11,18,0,-4,-11,20,-6,-14,-20,63,3,0
2012,IL,18,85164,244467,329631,1,r,310624,152933,157691,720113,655229,64884,491760,150111,341649,720113,116050,142358,148220,113506,283978,120353,97042,66583,-8,11,18,0,-4,-11,20,-6,-14,-20,61,3,0
2012,IL,2,188303,69115,297712,1,d,270520,126405,144115,709903,268842,441061,460938,96387,364551,709903,117458,137983,139050,96079,258134,143111,75694,39329,-8,11,18,0,-4,-11,20,-6,-14,-20,74,3,0
2012,IL,3,168738,77653,246398,1,d,258482,127229,131253,704438,544699,159739,469853,117650,352203,704438,124444,143882,138118,92143,238923,99940,79923,59060,-8,11,18,0,-4,-11,20,-6,-14,-20,44,3,1
2012,IL,4,133226,27279,160509,1,d,347897,177265,170632,712964,439311,273653,437294,83182,354112,712964,158661,153489,103247,57141,215933,124904,61221,29808,-8,11,18,0,-4,-11,20,-6,-14,-20,41,3,0
2012,IL,5,177729,77289,270377,1,d,257625,125024,132601,718231,580321,137910,518226,256977,261249,718231,193893,154801,121423,89136,298897,116466,86992,95439,-8,11,18,0,-4,-11,20,-6,-14,-20,45,3,1
2012,IL,6,132991,193138,326129,1,r,239587,116721,122866,725312,620413,104899,498760,251655,247105,725312,99070,156382,164131,96256,262191,69415,75623,117153,-8,11,18,0,-4,-11,20,-6,-14,-20,49,3,1
2012,IL,7,242439,31466,286435,1,d,349034,166374,182660,736759,241277,495482,485201,184600,300601,736759,180441,144448,121604,76364,290308,152601,72687,65020,-8,11,18,0,-4,-11,20,-6,-14,-20,70,3,2
2012,IL,8,123206,101860,225066,0,r,300737,150450,150287,726418,505409,221009,481192,157985,323207,726418,141862,155696,138165,73131,250448,94423,89503,66522,-8,11,18,0,-4,-11,20,-6,-14,-20,46,3,0
2012,IL,9,194869,98924,293807,0,d,255163,124651,130512,719112,524545,194567,500485,256971,243514,719112,130713,142072,143700,112348,285240,123018,79281,82941,-8,11,18,0,-4,-11,20,-6,-14,-20,54,3,2
2012,IN,1,187743,91291,279034,1,d,283209,138402,144807,721586,505137,216449,480676,98060,382616,721586,118919,143613,146640,99726,262858,129811,82896,50151,-8,11,18,0,-4,-11,20,-6,-14,-20,63,3,0
2012,IN,2,130113,134033,273475,0,d,354249,175618,178631,718237,624834,93403,466227,95778,370449,718237,115428,137494,140689,101909,268278,147806,84803,35669,-8,11,18,0,-4,-11,20,-6,-14,-20,58,3,0
2012,IN,3,92363,187872,280235,1,r,359843,177341,182502,725862,639112,86750,468506,100269,368237,725862,114747,140393,140030,98625,274733,145024,90308,39401,-8,11,18,0,-4,-11,20,-6,-14,-20,61,3,0
2012,IN,4,93015,168688,272268,1,r,408412,204459,203953,730336,668395,61941,468295,106776,361519,730336,129870,139735,137699,98790,274260,139151,88584,46525,-8,11,18,0,-4,-11,20,-6,-14,-20,55,3,0
2012,IN,5,125347,194570,333359,0,r,286622,139617,147005,734074,624451,109623,489601,207516,282085,734074,126695,154263,143273,93261,284174,118561,88579,77034,-8,11,18,0,-4,-11,20,-6,-14,-20,65,3,1
2012,IN,6,96678,162613,275253,0,r,349570,171469,178101,720934,672514,48420,480390,87249,393141,720934,106961,143968,145921,111587,273132,151375,88456,33301,-8,11,18,0,-4,-11,20,-6,-14,-20,60,3,1
2012,IN,7,162122,95828,257950,0,d,424425,204820,219605,735936,439760,296176,468482,103573,364909,735936,153188,145713,128943,76175,283415,176351,76944,30120,-8,11,18,0,-4,-11,20,-6,-14,-20,69,3,0
2012,IN,8,122325,151533,283992,0,r,204943,101971,102972,722056,668105,53951,484335,91438,392897,722056,118125,137063,148572,111425,281272,154139,88952,38181,-8,11,18,0,-4,-11,20,-6,-14,-20,66,3,1
2012,IN,9,132848,165332,298180,0,r,397213,196058,201155,728313,670695,57618,472433,111450,360983,728313,129854,142015,142250,97928,277955,145071,89298,43586,-8,11,18,0,-4,-11,20,-6,-14,-20,58,3,1
2012,KS,1,0,211337,211337,1,r,381394,193856,187538,725222,643345,81877,455529,103167,352362,725222,129132,124448,131221,106680,278056,151358,90305,36393,-8,11,18,0,-4,-11,20,-6,-14,-20,48,3,0
2012,KS,2,113735,167463,293718,0,r,367910,182288,185622,712841,626560,86281,464721,126716,338005,712841,118885,130159,139014,106369,277653,147385,87480,42788,-8,11,18,0,-4,-11,20,-6,-14,-20,59,3,1
2012,KS,3,0,201087,293762,1,r,331340,162361,168979,731176,598855,132321,481975,212079,269896,731176,130440,152380,139060,84534,282284,109367,89516,83401,-8,11,18,0,-4,-11,20,-6,-14,-20,57,3,1
2012,KS,4,81770,161094,258922,1,r,310336,153518,156818,716666,600124,116542,460999,124280,336719,716666,122937,133207,136460,96641,275918,145826,85479,44613,-8,11,18,0,-4,-11,20,-6,-14,-20,55,3,0
2012,KY,1,87199,199956,287155,1,r,321155,158826,162329,725929,651933,73996,489181,74807,414374,725929,118393,137258,146937,118198,283181,177514,76669,28998,-8,11,18,0,-4,-11,20,-6,-14,-20,70,3,2
2012,KY,2,89541,181508,282267,1,r,338297,165109,173188,733449,656118,77331,483536,88438,395098,733449,120143,146863,145674,100590,281491,157627,84921,38943,-8,11,18,0,-4,-11,20,-6,-14,-20,66,3,2
2012,KY,3,206385,111452,322656,1,d,346758,167404,179354,732786,533501,199285,497873,149415,348458,732786,137405,144561,145918,102110,301059,163236,86479,51344,-8,11,18,0,-4,-11,20,-6,-14,-20,72,3,1
2012,KY,4,104734,186036,299444,0,r,359127,178332,180795,735547,681685,53862,489846,127376,362470,735547,119283,154305,149238,91561,272932,126506,90331,56095,-8,11,18,0,-4,-11,20,-6,-14,-20,61,3,1
2012,KY,5,55447,195408,250855,1,r,250715,125114,125601,716945,692387,24558,493284,56644,436640,716945,111703,149585,149359,108229,276211,194873,59321,22017,-8,11,18,0,-4,-11,20,-6,-14,-20,64,3,3
2012,KY,6,141438,153222,303000,1,d,408060,200311,207749,735759,628993,106766,481741,142465,339276,735759,137026,149349,141036,92938,292130,160901,83490,47739,-8,11,18,0,-4,-11,20,-6,-14,-20,66,3,1
2012,LA,1,61703,218340,290410,1,r,341837,165564,176273,766284,608985,157299,516288,143256,373032,766284,136792,148289,155104,107871,291233,143070,85699,62464,-8,11,18,0,-4,-11,20,-6,-14,-20,65,3,0
2012,LA,2,230417,50146,287354,0,d,349007,167049,181958,771285,248309,522976,503072,105326,397746,771285,152392,149334,150548,87449,290219,185399,68568,36252,-8,11,18,0,-4,-11,20,-6,-14,-20,78,3,1
2012,LA,3,67070,240558,311393,0,r,418655,204504,214151,762579,540355,222224,491714,91833,399881,762579,140864,145615,145475,95142,286900,157916,78744,50240,-8,11,18,0,-4,-11,20,-6,-14,-20,76,3,-1
2012,LA,4,0,187894,249531,1,r,326673,161024,165649,763545,467675,295870,495990,95076,400914,763545,134267,142863,144157,106609,285128,166100,75575,43453,-8,11,18,0,-4,-11,20,-6,-14,-20,77,3,1
2012,LA,5,0,202536,260216,1,r,362380,178694,183686,758851,471738,287113,494398,84231,410167,758851,131983,143437,144096,107717,276397,173248,68979,34170,-8,11,18,0,-4,-11,20,-6,-14,-20,79,3,0
2012,LA,6,0,243553,306713,1,r,308577,152640,155937,779349,554444,224905,505143,140346,364797,779349,152675,152031,142969,92962,289596,132729,91241,65626,-8,11,18,0,-4,-11,20,-6,-14,-20,74,3,0
2012,MA,1,261936,0,336555,0,d,265332,127482,137850,723665,602686,120979,491869,138299,353570,723665,105782,139614,154832,116727,282868,140847,85215,56806,-8,11,18,0,-4,-11,20,-6,-14,-20,51,3,1
2012,MA,2,259257,0,342736,0,d,278671,135815,142856,745433,635587,109846,487551,175411,312140,745433,113820,153317,151499,95724,272895,113201,83339,76355,-8,11,18,0,-4,-11,20,-6,-14,-20,53,3,2
2012,MA,3,212119,109372,335111,0,d,266818,132129,134689,735424,569930,165494,499051,176253,322798,735424,113602,159786,156939,92830,271742,106928,74997,89817,-8,11,18,0,-4,-11,20,-6,-14,-20,48,3,2
2012,MA,4,221303,129936,373114,0,d,231252,110297,120955,733708,643772,89936,494651,240549,254102,733708,104948,159028,150870,103809,267385,83914,72260,111211,-8,11,18,0,-4,-11,20,-6,-14,-20,53,3,3
2012,MA,5,257490,82944,364201,0,d,311368,149201,162167,743098,591804,151294,525566,274743,250823,743098,138993,156002,146290,108206,290206,96301,78786,115119,-8,11,18,0,-4,-11,20,-6,-14,-20,52,3,3
2012,MA,6,180942,176612,389852,1,d,277265,135501,141764,745067,642015,103052,521756,209002,312754,745067,109440,154132,166649,116008,280209,91043,82627,106539,-8,11,18,0,-4,-11,20,-6,-14,-20,51,3,1
2012,MA,7,210794,0,285134,0,d,360182,175009,185173,745166,385974,359192,480274,185863,294411,745166,209865,137995,111329,76193,279022,139694,75284,64044,-8,11,18,0,-4,-11,20,-6,-14,-20,62,3,2
2012,MA,8,263999,82242,371694,0,d,241477,115844,125633,743817,586824,156993,529776,220886,308890,743817,143634,152827,148936,111476,289685,104464,83676,101545,-8,11,18,0,-4,-11,20,-6,-14,-20,61,3,1
2012,MA,9,212754,116531,385799,0,d,220538,107297,113241,730766,665304,65462,526115,168939,357176,730766,102291,145656,163159,140058,288382,122382,90931,75069,-8,11,18,0,-4,-11,20,-6,-14,-20,57,3,1
2012,MD,1,107670,214204,337760,1,r,297738,146622,151116,728148,603580,124568,500818,145623,355195,728148,106007,145327,160973,119300,270272,102186,87048,81038,-8,11,18,0,-4,-11,20,-6,-14,-20,70,3,1
2012,MD,2,194088,92071,295940,1,d,317401,150494,166907,732150,419782,312368,488724,139798,348926,732150,143920,151800,138996,87394,273691,114255,90021,69415,-8,11,18,0,-4,-11,20,-6,-14,-20,73,3,1
2012,MD,3,213747,94549,319859,1,d,267870,129285,138585,724325,473183,251142,499851,230244,269607,724325,148592,144449,138541,100867,279449,89351,84352,105746,-8,11,18,0,-4,-11,20,-6,-14,-20,67,3,2
2012,MD,4,240385,64560,311512,1,d,340209,162792,177417,733160,231641,501519,486912,149350,337562,733160,142154,156869,140045,78475,261181,84261,91159,85761,-8,11,18,0,-4,-11,20,-6,-14,-20,71,3,1
2012,MD,5,238618,95271,343820,1,d,285062,140298,144764,736564,391763,344801,481453,160857,320596,736564,120854,156742,153738,81803,252854,66061,77626,109167,-8,11,18,0,-4,-11,20,-6,-14,-20,73,3,2
2012,MD,6,181921,117313,309549,0,r,281286,138954,142332,743616,527449,216167,503538,194948,308590,743616,125763,163083,147574,93725,267722,93355,80959,93408,-8,11,18,0,-4,-11,20,-6,-14,-20,58,3,2
2012,MD,7,247770,67405,323818,1,d,282346,133635,148711,738549,259947,478602,493845,175507,318338,738549,135169,144508,149375,97660,277649,136421,70321,70907,-8,11,18,0,-4,-11,20,-6,-14,-20,76,3,2
2012,MD,8,217531,113033,343256,1,d,321323,156246,165077,748051,510345,237706,516994,270660,246334,748051,122615,160620,155184,103457,274899,68637,77740,128522,-8,11,18,0,-4,-11,20,-6,-14,-20,56,3,4
2012,ME,1,236363,128440,380715,1,d,237072,115212,121860,666642,631679,34963,478515,165668,312847,666642,95606,136699,152655,112590,276675,132873,88957,54845,-8,11,18,0,-4,-11,20,-6,-14,-20,57,3,0
2012,ME,2,191456,137542,343908,1,d,262046,129229,132817,662550,632649,29901,468502,99061,369441,662550,95070,130030,154309,113383,277868,159116,86736,32016,-8,11,18,0,-4,-11,20,-6,-14,-20,56,3,0
2012,MI,1,165179,167060,347037,1,r,272134,138980,133154,705862,652080,53782,509163,113410,395753,705862,99416,130008,165261,140332,293940,172696,88866,32378,-8,11,18,0,-4,-11,20,-6,-14,-20,61,3,1
2012,MI,10,97734,226075,328612,1,r,197635,97439,100196,702490,651214,51276,484209,103607,380602,702490,98354,149424,152999,105264,268429,124295,86198,57936,-8,11,18,0,-4,-11,20,-6,-14,-20,60,3,1
2012,MI,11,158879,181788,358139,0,r,251851,123676,128175,716311,596561,119750,494591,217975,276616,716311,109141,159396,151102,99039,275638,97260,85901,92477,-8,11,18,0,-4,-11,20,-6,-14,-20,57,3,1
2012,MI,12,216884,92472,319223,0,d,268801,130426,138375,707109,563767,143342,457661,141993,315668,707109,137505,136539,136606,87118,272526,139847,79625,53054,-8,11,18,0,-4,-11,20,-6,-14,-20,63,3,2
2012,MI,13,235336,38769,284270,0,d,293724,142057,151667,695949,262732,433217,442977,60268,382709,695949,120164,134811,134978,85885,257233,178622,58596,20015,-8,11,18,0,-4,-11,20,-6,-14,-20,77,3,0
2012,MI,14,270450,51395,328792,0,d,239741,112047,127694,697620,242371,455249,460031,135509,324522,697620,108842,137733,142771,99592,265756,156090,66877,42789,-8,11,18,0,-4,-11,20,-6,-14,-20,76,3,2
2012,MI,2,108973,194653,318267,1,r,325550,162069,163481,709805,618573,91232,463307,105232,358075,709805,119610,137853,138057,96646,264639,140317,87898,36424,-8,11,18,0,-4,-11,20,-6,-14,-20,56,3,0
2012,MI,3,144108,171675,326283,1,r,341518,167443,174075,715155,606698,108457,463637,130693,332944,715155,124692,138355,139733,91663,266817,133881,86204,46732,-8,11,18,0,-4,-11,20,-6,-14,-20,63,3,0
2012,MI,4,104996,197386,312949,1,r,302899,151291,151608,703135,662240,40895,469055,93859,375196,703135,108052,129480,146845,116341,271283,154469,79833,36981,-8,11,18,0,-4,-11,20,-6,-14,-20,56,3,1
2012,MI,5,214531,103931,330146,0,d,267405,129051,138354,697597,541363,156234,470369,84075,386294,697597,106486,134960,146140,110749,280661,171319,78051,31291,-8,11,18,0,-4,-11,20,-6,-14,-20,73,3,1
2012,MI,6,136563,174955,320475,1,r,322399,158907,163492,708661,603221,105440,466438,117206,349232,708661,115670,134733,144362,105271,272772,150488,83210,39074,-8,11,18,0,-4,-11,20,-6,-14,-20,64,3,1
2012,MI,7,136849,169668,318069,1,r,288658,144155,144503,702643,645176,57467,479214,106570,372644,702643,101371,141234,154076,105980,267753,133946,88578,45229,-8,11,18,0,-4,-11,20,-6,-14,-20,61,3,0
2012,MI,8,128657,202217,345054,1,r,309174,151784,157390,708716,613176,95540,456151,174035,282116,708716,109769,142121,146547,88515,266089,110229,83615,72245,-8,11,18,0,-4,-11,20,-6,-14,-20,61,3,1
2012,MI,9,208846,114760,337316,0,d,241360,117621,123739,712307,581254,131053,504215,138971,365244,712307,124388,147251,152727,110228,295532,149010,90672,55850,-8,11,18,0,-4,-11,20,-6,-14,-20,68,3,1
2012,MN,1,193211,142164,335880,1,d,312338,154609,157729,667630,616511,51119,441943,117644,324299,667630,116554,123194,129229,102882,261295,120671,91000,49624,-8,11,18,0,-4,-11,20,-6,-14,-20,52,3,0
2012,MN,2,164338,193587,358446,1,r,243378,119890,123488,673690,583025,90665,446691,164276,282415,673690,108755,148957,132207,76428,252724,85479,84497,82748,-8,11,18,0,-4,-11,20,-6,-14,-20,55,3,-1
2012,MN,3,159937,222335,382705,1,r,247949,121181,126768,677779,561044,116735,467853,219911,247942,677779,107612,143325,147190,89084,265513,84087,83405,98021,-8,11,18,0,-4,-11,20,-6,-14,-20,59,3,0
2012,MN,4,216685,109659,347991,1,d,260396,127292,133104,678318,504028,174290,445300,185559,259741,678318,128731,130297,131692,83706,264845,112144,82480,70221,-8,11,18,0,-4,-11,20,-6,-14,-20,59,3,1
2012,MN,5,262102,88753,351969,1,d,314559,155662,158897,683365,477221,206144,456470,197696,258774,683365,175168,131269,117998,72208,287315,140809,84876,61630,-8,11,18,0,-4,-11,20,-6,-14,-20,63,3,0
2012,MN,6,174944,179240,355153,1,r,244003,123592,120411,676155,622669,53486,436197,118382,317815,676155,112835,149367,127696,70148,241680,83021,89723,68936,-8,11,18,0,-4,-11,20,-6,-14,-20,57,3,-1
2012,MN,7,197791,114151,327576,1,d,319092,159421,159671,660525,613086,47439,446320,93003,353317,660525,97290,116048,136429,118935,265968,132878,92840,40250,-8,11,18,0,-4,-11,20,-6,-14,-20,48,3,-1
2012,MN,8,191976,160520,353663,1,r,237023,119965,117058,661677,619110,42567,459970,98869,361101,661677,100272,122071,146423,116519,272603,141407,93260,37936,-8,11,18,0,-4,-11,20,-6,-14,-20,55,3,0
2012,MO,1,267927,60832,340583,1,d,348818,164973,183845,739775,325286,414489,488175,138335,349840,739775,153724,140907,137931,90609,311951,191457,81865,38629,-8,11,18,0,-4,-11,20,-6,-14,-20,78,3,2
2012,MO,2,146272,236971,394448,0,r,290834,139992,150842,758082,678780,79302,530857,247589,283268,758082,110671,153230,166137,122952,296690,100389,95198,101103,-8,11,18,0,-4,-11,20,-6,-14,-20,59,3,1
2012,MO,3,111189,214843,338385,0,d,314280,156210,158070,754587,702520,52067,507356,117972,389384,754587,127935,150537,152562,104608,284965,132388,99618,52959,-8,11,18,0,-4,-11,20,-6,-14,-20,63,3,0
2012,MO,4,113120,192237,318723,1,r,368295,184868,183427,755257,677718,77539,484874,116633,368241,755257,133750,133874,142622,112848,288409,166581,87449,34379,-8,11,18,0,-4,-11,20,-6,-14,-20,62,3,1
2012,MO,5,200290,122149,330942,1,d,334899,162470,172429,753184,520341,232843,504315,126201,378114,753184,144677,144556,145268,103113,303962,175099,89847,39016,-8,11,18,0,-4,-11,20,-6,-14,-20,70,3,1
2012,MO,6,108503,216906,333688,1,r,291601,144644,146957,755177,685684,69493,501552,129959,371593,755177,118789,151220,148850,108886,285220,141951,91848,51421,-8,11,18,0,-4,-11,20,-6,-14,-20,61,3,0
2012,MO,7,98498,203565,318740,1,r,358983,176086,182897,756482,699583,56899,498327,111799,386528,756482,133001,140961,142784,116462,298651,181278,85983,31390,-8,11,18,0,-4,-11,20,-6,-14,-20,52,3,0
2012,MO,8,73755,216083,300391,1,r,345761,172361,173400,749444,692087,57357,508185,74182,434003,749444,111962,143830,153803,124847,289287,185354,76341,27592,-8,11,18,0,-4,-11,20,-6,-14,-20,69,3,1
2012,MS,1,114076,186760,309177,0,r,326175,156523,169652,750432,522345,228087,484614,93359,391255,750432,120491,146624,139990,104253,278505,169589,74487,34429,-8,11,18,0,-4,-11,20,-6,-14,-20,77,3,0
2012,MS,2,214978,99160,320244,1,d,338017,160731,177286,726870,238973,487897,451546,80094,371452,726870,118578,133649,134924,93927,253098,175800,55333,21965,-8,11,18,0,-4,-11,20,-6,-14,-20,81,3,0
2012,MS,3,0,234717,293322,1,r,398665,194094,204571,752313,460216,292097,488758,124154,364604,752313,123539,146381,144221,103632,277303,162461,73124,41718,-8,11,18,0,-4,-11,20,-6,-14,-20,79,3,1
2012,MS,4,82344,182998,285432,0,r,367836,180216,187620,755311,547202,208109,487050,97409,389641,755311,132982,146745,142179,100912,281615,169566,76196,35853,-8,11,18,0,-4,-11,20,-6,-14,-20,74,3,1
2012,MT,1,204939,255468,479740,0,r,339120,169859,169261,1005141,896467,108674,686770,201929,484841,1005141,166237,185227,219007,158585,408938,222223,124424,62291,-8,11,18,0,-4,-11,20,-6,-14,-20,46,3,0
2012,NC,1,254644,77288,338066,1,d,421479,200447,221032,733833,287191,446642,472141,87988,384153,733833,124884,134315,139067,108049,279543,187443,66623,25477,-8,11,18,0,-4,-11,20,-6,-14,-20,77,3,0
2012,NC,10,144023,190826,334849,1,r,368060,178558,189502,741547,609331,132216,513784,116663,397121,741547,113929,156165,156407,116091,290030,169855,80747,39428,-8,11,18,0,-4,-11,20,-6,-14,-20,67,3,0
2012,NC,11,141107,190319,331426,0,d,395337,195073,200264,735269,666388,68881,524889,112846,412043,735269,96362,141037,158267,149969,294839,180003,87064,27772,-8,11,18,0,-4,-11,20,-6,-14,-20,56,3,0
2012,NC,12,247591,63317,310908,1,d,430932,207607,223325,775088,291592,483496,477550,114786,362764,775088,178697,155208,125015,65296,283353,185947,71291,26115,-8,11,18,0,-4,-11,20,-6,-14,-20,71,3,-1
2012,NC,13,160115,210495,370610,0,d,353532,173353,180179,758057,568004,190053,511930,195276,316654,758057,110830,173012,156928,89564,283944,114128,90824,78992,-8,11,18,0,-4,-11,20,-6,-14,-20,66,3,0
2012,NC,2,128973,174066,311397,0,r,361038,176441,184597,766976,559500,207476,498340,138300,360040,766976,136167,160496,135187,96613,282714,140900,91276,50538,-8,11,18,0,-4,-11,20,-6,-14,-20,63,3,0
2012,NC,3,114314,195571,309885,1,r,385576,193566,192010,747569,560438,187131,477561,105477,372084,747569,153944,134554,137452,102255,284457,160629,85370,38458,-8,11,18,0,-4,-11,20,-6,-14,-20,69,3,0
2012,NC,4,259534,88951,348485,1,d,391421,187110,204311,759828,416932,342896,478700,195483,283217,759828,178078,151947,120682,74342,295537,151521,86588,57428,-8,11,18,0,-4,-11,20,-6,-14,-20,69,3,2
2012,NC,5,148252,200945,349197,1,r,406815,197507,209308,741095,611032,130063,501500,129545,371955,741095,111183,152431,151397,115379,298639,174315,81071,43253,-8,11,18,0,-4,-11,20,-6,-14,-20,63,3,0
2012,NC,6,142467,222116,364583,1,r,376321,182708,193613,741006,577450,163556,517473,140362,377111,741006,108631,157221,159120,119004,295886,157350,86869,51667,-8,11,18,0,-4,-11,20,-6,-14,-20,68,3,0
2012,NC,7,168695,168041,336736,1,d,434888,213426,221462,748939,555199,193740,515595,121030,394565,748939,110526,154884,154613,119549,287467,153267,90781,43419,-8,11,18,0,-4,-11,20,-6,-14,-20,67,3,0
2012,NC,8,137139,160695,302280,1,d,445084,219219,225865,741884,514537,227347,490693,79732,410961,741884,110300,157130,143290,105415,270711,157673,80964,32074,-8,11,18,0,-4,-11,20,-6,-14,-20,67,3,0
2012,NC,9,171503,194537,375690,0,r,315946,153004,162942,760982,599847,161135,509727,238370,271357,760982,117861,184080,141130,85174,284205,97101,92887,94217,-8,11,18,0,-4,-11,20,-6,-14,-20,63,3,0
2012,ND,1,0,173585,316224,0,r,313680,160327,153353,699628,626192,73436,457904,127875,330029,699628,135710,123917,134273,100962,290944,135791,93844,61309,-8,11,18,0,-4,-11,20,-6,-14,-20,55,3,-1
2012,NE,1,81206,174889,256095,1,r,266027,132511,133516,620321,563064,57257,394711,114404,280307,620321,112986,113859,114348,84111,242674,116856,81576,44242,-8,11,18,0,-4,-11,20,-6,-14,-20,50,3,0
2012,NE,2,129767,133964,263731,1,r,332113,164657,167456,627439,500089,127350,403399,152749,250650,627439,126101,125120,111792,66309,242352,111378,77030,53944,-8,11,18,0,-4,-11,20,-6,-14,-20,59,3,0
2012,NE,3,65266,187423,252689,1,r,272785,136012,136773,607765,571799,35966,408798,82509,326289,607765,89123,109156,126397,106552,248544,132311,83951,32282,-8,11,18,0,-4,-11,20,-6,-14,-20,43,3,0
2012,NH,1,171650,158659,345022,0,r,259248,126616,132632,660114,619211,40903,461462,154170,307292,660114,94763,141100,147841,99098,260771,101782,88100,70889,-8,11,18,0,-4,-11,20,-6,-14,-20,53,3,1
2012,NH,2,169275,152977,337394,0,r,276079,136195,139884,660604,622694,37910,458421,163721,294700,660604,97040,137574,151214,94999,258366,102123,83714,72529,-8,11,18,0,-4,-11,20,-6,-14,-20,51,3,1
2012,NJ,1,210470,92459,308519,1,d,252478,122057,130421,730393,497654,232739,492756,143178,349578,730393,127121,149377,146184,100483,267624,109559,83926,74139,-8,11,18,0,-4,-11,20,-6,-14,-20,62,3,0
2012,NJ,10,201435,24271,230060,0,d,267497,128086,139411,720703,211527,509176,477448,124848,352600,720703,136318,154252,136082,83089,264277,143472,70482,50323,-8,11,18,0,-4,-11,20,-6,-14,-20,69,3,1
2012,NJ,11,123897,182237,309859,1,r,205915,98950,106965,730671,608365,122306,517272,257899,259373,730671,97232,155202,164895,119658,265620,63537,73795,128288,-8,11,18,0,-4,-11,20,-6,-14,-20,50,3,1
2012,NJ,12,189926,80906,274378,1,d,297114,145008,152106,743701,434762,308939,504177,213480,290697,743701,120395,165328,143954,99949,259128,83727,75803,99598,-8,11,18,0,-4,-11,20,-6,-14,-20,57,3,2
2012,NJ,2,116462,166677,289069,1,r,314637,154085,160552,734730,543406,191324,506515,119394,387121,734730,112743,147354,155835,119595,267827,119952,84100,63775,-8,11,18,0,-4,-11,20,-6,-14,-20,58,3,0
2012,NJ,3,145506,174253,324399,1,r,217086,105267,111819,741972,603920,138052,519772,163496,356276,741972,106979,152476,156308,129955,280665,99757,91059,89849,-8,11,18,0,-4,-11,20,-6,-14,-20,63,3,0
2012,NJ,4,107991,195145,306247,1,r,241334,117761,123573,731763,630991,100772,493714,184487,309227,731763,99870,145178,148895,122312,270053,92400,79486,98167,-8,11,18,0,-4,-11,20,-6,-14,-20,53,3,1
2012,NJ,5,130100,167501,304371,1,r,211667,102584,109083,742297,584716,157581,517582,237175,280407,742297,98305,159439,170263,111495,265617,73020,73733,118864,-8,11,18,0,-4,-11,20,-6,-14,-20,50,3,1
2012,NJ,6,151782,84360,239638,1,d,300951,149230,151721,740331,491296,249035,496251,186539,309712,740331,137919,152737,147063,90949,257221,89350,78263,89608,-8,11,18,0,-4,-11,20,-6,-14,-20,51,3,1
2012,NJ,7,123057,175662,307315,1,r,225486,111160,114326,744206,598904,145302,509889,253265,256624,744206,91320,170516,166902,101280,265422,64887,69752,130783,-8,11,18,0,-4,-11,20,-6,-14,-20,49,3,2
2012,NJ,8,130853,31763,167790,0,d,345170,171319,173851,757415,425471,331944,512403,149077,363326,757415,192277,166499,117351,74058,272812,131185,76126,65501,-8,11,18,0,-4,-11,20,-6,-14,-20,46,3,1
2012,NJ,9,162822,55091,220133,0,d,278837,135541,143296,746408,480663,265745,501573,159345,342228,746408,137251,164089,134288,97491,262533,112162,75343,75028,-8,11,18,0,-4,-11,20,-6,-14,-20,50,3,0
2012,NM,1,162924,112473,275856,0,d,359669,177124,182545,693772,478973,214799,463621,143474,320147,693772,133932,132448,138483,93561,271264,144729,78580,47955,-8,11,18,0,-4,-11,20,-6,-14,-20,41,3,2
2012,NM,2,92162,133180,225515,0,r,334011,168246,165765,697941,560674,137267,442809,88257,354552,697941,114575,122617,127788,103195,243579,147284,65017,31278,-8,11,18,0,-4,-11,20,-6,-14,-20,40,3,1
2012,NM,3,167103,97616,264719,0,d,335797,165355,170442,693825,460206,233619,453900,123557,330343,693825,107098,131358,138499,97502,250153,135753,69485,44915,-8,11,18,0,-4,-11,20,-6,-14,-20,41,3,2
2012,NV,1,113967,56521,179278,0,d,328992,169432,159560,671913,410479,261434,443314,61939,381375,671913,126546,143676,123173,81760,241160,156437,61294,23429,-8,11,18,0,-4,-11,20,-6,-14,-20,46,3,0
2012,NV,2,102019,162213,281449,0,r,315687,160477,155210,687019,571775,115244,461039,110643,350396,687019,120638,133603,140188,97966,260241,126769,82460,51012,-8,11,18,0,-4,-11,20,-6,-14,-20,44,3,0
2012,NV,3,116823,137244,272523,0,r,231629,113689,117940,709730,495013,214717,492793,149945,342848,709730,140341,155150,130438,95068,265265,102660,99621,62984,-8,11,18,0,-4,-11,20,-6,-14,-20,51,3,0
2012,NV,4,120501,101261,240492,0,,295087,148869,146218,690269,444936,245333,443496,89270,354226,690269,125525,135917,125006,84692,239939,119577,78532,41830,-8,11,18,0,-4,-11,20,-6,-14,-20,53,3,0
2012,NY,1,134205,106678,294578,1,d,318382,161719,156663,723680,639937,83743,494635,167288,327347,723680,107207,154978,149841,109449,245445,67399,72664,105382,-8,11,18,0,-4,-11,20,-6,-14,-20,51,3,2
2012,NY,10,155908,35440,236323,0,d,287352,139878,147474,723234,521013,202221,518646,300773,217873,723234,176951,149450,128842,96597,311400,114427,74669,122304,-8,11,18,0,-4,-11,20,-6,-14,-20,49,3,3
2012,NY,11,87718,91030,214755,0,d,190902,91523,99379,729998,522029,207969,499658,158358,341300,729998,132388,152281,141751,105566,259230,104350,80511,74369,-8,11,18,0,-4,-11,20,-6,-14,-20,51,3,1
2012,NY,12,184864,41969,268287,0,d,339176,160486,178690,705637,538578,167059,561658,394576,167082,705637,234511,150707,117134,99291,368762,114780,97246,156736,-8,11,18,0,-4,-11,20,-6,-14,-20,50,3,2
2012,NY,13,170470,12132,233172,0,d,315367,147949,167418,757166,198271,558895,509096,141850,367246,757166,180854,154287,129837,86710,271286,171088,67678,32520,-8,11,18,0,-4,-11,20,-6,-14,-20,54,3,1
2012,NY,14,116117,19191,170995,0,d,311761,157934,153827,725501,335671,389830,501651,120240,381411,725501,173656,155308,125893,87792,245148,126657,72896,45595,-8,11,18,0,-4,-11,20,-6,-14,-20,46,3,0
2012,NY,15,150243,3487,178645,0,d,319276,149765,169511,724874,108969,615905,421619,49784,371835,724874,148705,141763,110279,60828,239061,183462,42752,12847,-8,11,18,0,-4,-11,20,-6,-14,-20,52,3,-1
2012,NY,16,173885,53935,270320,0,d,246788,115706,131082,728126,346471,381655,490264,187625,302639,728126,114193,147598,140709,114382,262649,113526,70885,78238,-8,11,18,0,-4,-11,20,-6,-14,-20,63,3,2
2012,NY,17,161624,91899,297379,0,d,275864,134871,140993,732626,515449,217177,484489,211346,273143,732626,106934,150399,145258,105820,240995,75017,63971,102007,-8,11,18,0,-4,-11,20,-6,-14,-20,53,3,2
2012,NY,18,132456,113386,295436,0,d,244931,120514,124417,717264,570230,147034,468930,160408,308522,717264,99663,151599,149813,92941,245554,83919,71744,89891,-8,11,18,0,-4,-11,20,-6,-14,-20,55,3,2
2012,NY,19,120302,122654,305882,0,d,235064,117891,117173,712305,636541,75764,496692,133821,362871,712305,96544,140794,164386,120383,272355,123225,89822,59308,-8,11,18,0,-4,-11,20,-6,-14,-20,58,3,2
2012,NY,2,93375,116083,271832,0,d,298291,142760,155531,723128,557512,165616,489220,139324,349896,723128,112300,159074,144221,98880,229240,63525,70814,94901,-8,11,18,0,-4,-11,20,-6,-14,-20,51,3,1
2012,NY,20,181092,79102,317678,0,r,254179,122617,131562,723814,590036,133778,489090,171382,317708,723814,126095,140258,148329,106972,284227,120752,94374,69101,-8,11,18,0,-4,-11,20,-6,-14,-20,62,3,2
2012,NY,21,117856,104368,268741,0,d,253445,129658,123787,720703,665300,55403,491343,110130,381213,720703,122462,142700,148203,109363,283517,141541,94487,47489,-8,11,18,0,-4,-11,20,-6,-14,-20,61,3,2
2012,NY,22,102080,145042,280189,0,d,264436,130669,133767,713911,646056,67855,482802,114561,368241,713911,114223,131941,149939,117274,277524,147279,86400,43845,-8,11,18,0,-4,-11,20,-6,-14,-20,60,3,2
2012,NY,23,114590,117641,279796,0,d,358278,178483,179795,717153,659543,57610,477013,115810,361203,717153,113600,130177,149769,113843,282016,151098,87513,43405,-8,11,18,0,-4,-11,20,-6,-14,-20,57,3,3
2012,NY,24,133908,105584,303567,0,d,269317,131736,137581,712871,608489,104382,478234,133775,344459,712871,110696,139055,148889,106513,281238,137162,90411,53665,-8,11,18,0,-4,-11,20,-6,-14,-20,65,3,1
2012,NY,25,168761,109292,322760,0,d,272115,131357,140758,722261,545767,176494,482939,168594,314345,722261,127383,138089,143764,106808,288507,143187,87368,57952,-8,11,18,0,-4,-11,20,-6,-14,-20,66,3,2
2012,NY,26,195234,57368,304961,0,r,271071,130545,140526,712523,520746,191777,482223,140484,341739,712523,133595,129461,140382,114150,301529,168661,86798,46070,-8,11,18,0,-4,-11,20,-6,-14,-20,69,3,2
2012,NY,27,140008,137250,329768,0,d,205714,101776,103938,719387,673383,46004,503442,143918,359524,719387,100223,147348,166897,114365,283279,118852,99619,64808,-8,11,18,0,-4,-11,20,-6,-14,-20,60,3,2
2012,NY,3,146016,98455,306274,0,r,183311,87419,95892,714718,553180,161538,500903,250421,250482,714718,91180,142671,160560,126832,249397,65126,62472,121799,-8,11,18,0,-4,-11,20,-6,-14,-20,48,3,2
2012,NY,4,152590,84982,299484,1,d,246242,119626,126616,724357,494665,229692,495533,189540,305993,724357,110188,149795,152910,111450,237444,67105,63198,107141,-8,11,18,0,-4,-11,20,-6,-14,-20,56,3,2
2012,NY,5,167835,17875,224508,0,d,227215,107627,119588,756219,137813,618406,494558,114997,379561,756219,142673,156492,145919,89015,220905,95434,68034,57437,-8,11,18,0,-4,-11,20,-6,-14,-20,67,3,0
2012,NY,6,107505,45992,186932,0,d,246719,119725,126994,724352,356557,367795,532750,190907,341843,724352,139618,158812,151151,110112,270187,119506,86193,64488,-8,11,18,0,-4,-11,20,-6,-14,-20,47,3,1
2012,NY,7,132456,0,178825,0,d,332431,165807,166624,751575,373501,378074,488510,137226,351284,751575,192625,154481,113825,71363,246905,139300,59778,47827,-8,11,18,0,-4,-11,20,-6,-14,-20,47,3,1
2012,NY,8,178687,15841,236292,0,d,209108,94888,114220,722663,213991,508672,480726,133608,347118,722663,152189,144080,134292,89866,269936,149173,70121,50642,-8,11,18,0,-4,-11,20,-6,-14,-20,70,3,1
2012,NY,9,178168,20899,238957,0,d,232233,106300,125933,730215,237698,492517,493137,163016,330121,730215,155310,143679,135145,92896,271186,141238,77187,52761,-8,11,18,0,-4,-11,20,-6,-14,-20,73,3,1
2012,OH,1,131490,201907,349716,1,r,309151,149918,159233,731181,529661,201520,474322,148617,325705,731181,125682,146017,140854,90847,281302,140463,78325,62514,-8,11,18,0,-4,-11,20,-6,-14,-20,74,3,1
2012,OH,10,131097,208201,349671,0,d,326024,157449,168575,721777,558739,163038,483564,130421,353143,721777,124379,132938,145510,113076,293297,163737,82435,47125,-8,11,18,0,-4,-11,20,-6,-14,-20,74,3,2
2012,OH,11,258359,0,258359,1,d,240592,112794,127798,698259,282526,415733,463150,119366,343784,698259,119679,127758,143723,101223,293130,194366,63704,35060,-8,11,18,0,-4,-11,20,-6,-14,-20,78,3,2
2012,OH,12,134605,233869,368474,1,r,230740,114149,116591,738859,657548,81311,496587,189513,307074,738859,121883,156665,151629,95167,282130,111809,90522,79799,-8,11,18,0,-4,-11,20,-6,-14,-20,63,3,1
2012,OH,13,235492,88120,323612,0,d,297506,144914,152592,716143,603418,112725,490917,96174,394743,716143,117886,136107,150532,116914,296820,178020,86581,32219,-8,11,18,0,-4,-11,20,-6,-14,-20,72,3,0
2012,OH,14,131637,183657,339894,0,r,211392,103669,107723,720576,658312,62264,505103,161811,343292,720576,92675,146978,163315,121340,284565,123629,91514,69422,-8,11,18,0,-4,-11,20,-6,-14,-20,63,3,1
2012,OH,15,128188,205274,333462,1,r,299126,151019,148107,726053,662311,63742,479628,137000,342628,726053,129349,146166,139911,96897,268659,123896,92121,52642,-8,11,18,0,-4,-11,20,-6,-14,-20,64,3,0
2012,OH,16,170600,185165,355765,0,r,186464,90905,95559,722292,677111,45181,504982,157652,347330,722292,99600,141775,159121,127615,284940,121503,99595,63842,-8,11,18,0,-4,-11,20,-6,-14,-20,59,3,1
2012,OH,2,137077,194296,331373,0,r,280394,136644,143750,713709,625643,88066,489560,137633,351927,713709,117823,140846,151670,105529,288474,148620,84770,55084,-8,11,18,0,-4,-11,20,-6,-14,-20,73,3,1
2012,OH,3,201897,77901,295652,0,r,331096,160957,170139,733584,423442,310142,463821,119979,343842,733584,164990,145711,122822,69502,287988,173592,80576,33820,-8,11,18,0,-4,-11,20,-6,-14,-20,73,3,0
2012,OH,4,114214,182643,312998,1,r,244961,122069,122892,718059,654687,63372,484881,76497,408384,718059,111143,141746,149382,110720,276341,148684,89432,38225,-8,11,18,0,-4,-11,20,-6,-14,-20,65,3,1
2012,OH,5,137806,201514,351878,1,r,264910,129850,135060,726090,670994,55096,484649,114869,369780,726090,116470,136584,149692,112999,288749,144836,93985,49928,-8,11,18,0,-4,-11,20,-6,-14,-20,57,3,1
2012,OH,6,144444,164536,308980,1,r,339878,167881,171997,716828,684594,32234,503546,77360,426186,716828,106389,139677,156774,126604,283530,163498,86447,33585,-8,11,18,0,-4,-11,20,-6,-14,-20,71,3,0
2012,OH,7,137708,178104,315812,0,r,203056,99665,103391,726927,677351,49576,494639,89168,405471,726927,109253,143511,152153,116590,278332,145504,93028,39800,-8,11,18,0,-4,-11,20,-6,-14,-20,68,3,0
2012,OH,8,0,246378,248316,1,r,281485,138250,143235,724285,645416,78869,476499,105969,370530,724285,109580,143185,146780,103416,272956,137031,87750,48175,-8,11,18,0,-4,-11,20,-6,-14,-20,66,3,0
2012,OH,9,217771,68668,298164,1,d,232352,111640,120712,709603,535269,174334,474868,99283,375585,709603,122887,139091,144314,99129,293459,179651,80444,33364,-8,11,18,0,-4,-11,20,-6,-14,-20,65,3,0
2012,OK,1,91421,181084,285312,0,r,395547,192737,202810,764074,559721,204353,499740,143198,356542,764074,138556,149781,143459,99632,298956,153231,91991,53734,-8,11,18,0,-4,-11,20,-6,-14,-20,59,3,0
2012,OK,2,96081,143701,250612,0,d,362857,181050,181807,748575,505388,243187,499464,84244,415220,748575,113116,139474,146559,126378,285910,181015,77071,27824,-8,11,18,0,-4,-11,20,-6,-14,-20,59,3,0
2012,OK,3,53472,201744,268003,1,r,415881,209299,206582,759066,607446,151620,494744,103964,390780,759066,131092,139177,145477,112400,282637,150522,89286,42829,-8,11,18,0,-4,-11,20,-6,-14,-20,53,3,0
2012,OK,4,71846,176740,260331,1,r,305795,152541,153254,771753,599414,172339,493703,114377,379326,771753,149004,147464,138791,100263,282589,145007,90076,47506,-8,11,18,0,-4,-11,20,-6,-14,-20,58,3,0
2012,OK,5,97504,153603,261677,1,r,420768,205654,215114,771352,533643,237709,499805,145524,354281,771352,153603,144781,139630,97334,296575,167416,83398,45761,-8,11,18,0,-4,-11,20,-6,-14,-20,59,3,0
2012,OR,1,197845,109699,331980,0,d,339828,168051,171777,789881,633927,155954,533325,200025,333300,789881,146692,168984,151325,96037,298531,123689,95792,79050,-8,11,18,0,-4,-11,20,-6,-14,-20,45,3,1
2012,OR,2,96741,228043,332255,1,r,417723,207638,210085,774864,698808,76056,533737,120619,413118,774864,117037,141249,164817,139102,305889,174588,93800,37501,-8,11,18,0,-4,-11,20,-6,-14,-20,42,3,1
2012,OR,3,264979,70325,355875,1,d,342606,170325,172281,788710,633015,155695,553614,202669,350945,788710,171325,174631,152605,88897,308787,148109,94360,66318,-8,11,18,0,-4,-11,20,-6,-14,-20,53,3,1
2012,OR,4,212866,140549,360088,1,d,340302,168709,171593,769897,691917,77980,528613,128646,399967,769897,134697,133093,163280,138910,310162,181977,89039,39146,-8,11,18,0,-4,-11,20,-6,-14,-20,45,3,1
2012,OR,5,177229,139223,327970,1,d,383718,189498,194220,776001,663924,112077,522483,147495,374988,776001,124708,148181,158954,118747,293588,140518,94623,58447,-8,11,18,0,-4,-11,20,-6,-14,-20,42,3,0
2012,PA,1,235394,41708,277102,1,d,270197,128951,141246,710941,343674,367267,461923,109438,352485,710941,162289,136636,124655,77193,261325,158291,66372,36662,-8,11,18,0,-4,-11,20,-6,-14,-20,66,3,2
2012,PA,10,94227,179563,273790,0,r,226160,112498,113662,707613,663499,44114,494035,97153,396882,707613,102146,138829,154854,123570,270850,140764,89255,40831,-8,11,18,0,-4,-11,20,-6,-14,-20,58,3,1
2012,PA,11,118231,166967,285198,0,r,262409,128571,133838,702158,629296,72862,494374,110247,384127,702158,106803,140015,154503,120623,281829,143475,91803,46551,-8,11,18,0,-4,-11,20,-6,-14,-20,60,3,1
2012,PA,12,163589,175352,338941,1,d,194323,95361,98962,700573,653910,46663,503077,151331,351746,700573,97534,135893,158464,133745,288194,135419,89693,63082,-8,11,18,0,-4,-11,20,-6,-14,-20,66,3,1
2012,PA,13,209901,93918,303819,1,d,256803,123299,133504,715961,468902,247059,488935,155630,333305,715961,133472,144039,135572,106752,268325,126186,82120,60019,-8,11,18,0,-4,-11,20,-6,-14,-20,62,3,1
2012,PA,14,251932,75702,327634,1,d,331073,158679,172394,711042,515339,195703,498896,151005,347891,711042,152186,126045,146955,112841,317354,185007,88662,43685,-8,11,18,0,-4,-11,20,-6,-14,-20,76,3,2
2012,PA,15,128764,168960,297724,1,r,251401,122524,128877,707651,603189,104462,479824,130214,349610,707651,110825,139696,141626,113902,269749,122275,92590,54884,-8,11,18,0,-4,-11,20,-6,-14,-20,51,3,1
2012,PA,16,111185,156192,284781,1,r,307625,150394,157231,707348,588276,119072,457165,110761,346404,707348,110799,135336,134223,103319,257915,126536,82873,48506,-8,11,18,0,-4,-11,20,-6,-14,-20,52,3,0
2012,PA,17,161393,106208,267601,0,d,260483,127893,132590,707168,624722,82446,493862,95772,398090,707168,106975,138160,151281,123506,272920,144967,86926,41027,-8,11,18,0,-4,-11,20,-6,-14,-20,58,3,1
2012,PA,18,122146,216727,338873,1,r,297924,144949,152975,703959,660367,43592,512673,171404,341269,703959,95338,143718,162123,130762,288920,124036,96857,68027,-8,11,18,0,-4,-11,20,-6,-14,-20,62,3,1
2012,PA,2,318176,33381,356386,1,d,298106,138244,159862,712760,218076,494684,458872,152260,306612,712760,161848,122043,124396,93803,276753,168660,62299,45794,-8,11,18,0,-4,-11,20,-6,-14,-20,76,3,3
2012,PA,3,123933,165826,302514,1,r,260501,127877,132624,703111,645988,57123,484588,110539,374049,703111,100969,135751,150114,120838,281889,152414,86901,42574,-8,11,18,0,-4,-11,20,-6,-14,-20,68,3,0
2012,PA,4,104643,181603,303980,0,d,271396,133974,137422,712526,610748,101778,487951,119451,368500,712526,108084,146762,148979,107305,274634,124320,93496,56818,-8,11,18,0,-4,-11,20,-6,-14,-20,62,3,1
2012,PA,5,104725,177740,282465,1,r,364980,185737,179243,704058,660711,43347,469594,104103,365491,704058,117584,130275,145891,115165,275564,149544,87848,38172,-8,11,18,0,-4,-11,20,-6,-14,-20,61,3,1
2012,PA,6,143803,191725,335528,1,r,272784,132358,140426,720487,635727,84760,492213,201217,290996,720487,107365,149303,150984,106574,270332,88988,88943,92401,-8,11,18,0,-4,-11,20,-6,-14,-20,55,3,1
2012,PA,7,143509,209942,353451,1,r,229612,113344,116268,717111,632427,84684,490697,201097,289600,717111,98324,144685,155083,113976,260907,85408,78841,96658,-8,11,18,0,-4,-11,20,-6,-14,-20,62,3,2
2012,PA,8,152859,199379,352238,1,r,214162,105120,109042,710932,633462,77470,497310,180443,316867,710932,99500,150180,161012,109456,261404,83063,83807,94534,-8,11,18,0,-4,-11,20,-6,-14,-20,56,3,1
2012,PA,9,105128,169177,274305,1,r,311093,152451,158642,708137,668506,39631,490328,83469,406859,708137,104573,135609,148653,128600,279385,153861,89443,36081,-8,11,18,0,-4,-11,20,-6,-14,-20,66,3,0
2012,RI,1,108612,83737,205115,1,d,204630,99279,105351,533705,420815,112890,358158,111836,246322,533705,94198,104014,103415,81262,209649,103678,61125,44846,-8,11,18,0,-4,-11,20,-6,-14,-20,55,3,2
2012,RI,2,124067,78189,222660,1,d,205365,98551,106814,516587,437082,79505,354113,111907,242206,516587,81529,104711,112403,77563,203434,88404,61342,53688,-8,11,18,0,-4,-11,20,-6,-14,-20,51,3,1
2012,SC,1,98154,179908,290013,1,r,279410,134076,145334,699487,512860,186627,474503,171464,303039,699487,131300,134290,133213,105979,267534,120924,87924,58686,-8,11,18,0,-4,-11,20,-6,-14,-20,70,3,1
2012,SC,2,0,196116,203718,1,r,310498,151691,158807,670436,474303,196133,448632,144302,304330,670436,114118,136492,135361,90878,255609,122664,81325,51620,-8,11,18,0,-4,-11,20,-6,-14,-20,73,3,1
2012,SC,3,84735,169512,254763,1,r,356097,175032,181065,665638,514886,150752,442957,85917,357040,665638,96818,129929,133681,107557,249835,151569,67667,30599,-8,11,18,0,-4,-11,20,-6,-14,-20,73,3,1
2012,SC,4,84087,173201,266884,1,r,316534,153276,163258,673673,501041,172632,448869,128993,319876,673673,113580,137740,131107,93806,256493,142089,70580,43824,-8,11,18,0,-4,-11,20,-6,-14,-20,68,3,1
2012,SC,5,113904,154324,278003,1,r,341035,165230,175805,675124,462522,212602,446670,88817,357853,675124,102482,138029,134166,95728,252296,141988,74021,36287,-8,11,18,0,-4,-11,20,-6,-14,-20,76,3,0
2012,SC,6,218717,0,233615,1,d,367999,181617,186382,667790,257991,409799,425907,82596,343311,667790,129075,121755,124095,87219,239706,159068,59668,20970,-8,11,18,0,-4,-11,20,-6,-14,-20,79,3,1
2012,SC,7,114594,153068,275738,0,,377956,181518,196438,671575,442241,229334,464078,88933,375145,671575,107794,126170,141682,113609,265867,165707,69566,30594,-8,11,18,0,-4,-11,20,-6,-14,-20,76,3,0
2012,SD,1,153789,207640,361429,0,r,386916,193981,192935,833354,711562,121792,544292,142951,401341,833354,142871,149451,163118,121092,323765,167284,105575,50906,-8,11,18,0,-4,-11,20,-6,-14,-20,56,3,0
2012,TN,1,47663,182252,239672,1,r,381322,186141,195181,711525,673368,38157,501716,89939,411777,711525,108709,143724,151090,127024,289988,183257,76804,29927,-8,11,18,0,-4,-11,20,-6,-14,-20,58,3,0
2012,TN,2,54522,196894,264505,1,r,334275,162243,172032,714622,637964,76658,487466,138617,348849,714622,123239,142013,143416,112096,290381,160636,85483,44262,-8,11,18,0,-4,-11,20,-6,-14,-20,65,3,1
2012,TN,3,91094,157830,256909,0,r,344938,168181,176757,711391,606426,104965,492767,103487,389280,711391,112655,140670,148503,118524,277448,163422,75012,39014,-8,11,18,0,-4,-11,20,-6,-14,-20,70,3,1
2012,TN,4,102022,128568,230590,1,r,365483,179041,186442,720979,626013,94966,474630,95560,379070,720979,121327,151840,136073,95738,271487,153185,82326,35976,-8,11,18,0,-4,-11,20,-6,-14,-20,64,3,-1
2012,TN,5,171621,86240,263095,1,d,370321,179246,191075,725673,470600,255073,488058,168682,319376,725673,168106,146310,130691,79474,286988,157745,83344,45899,-8,11,18,0,-4,-11,20,-6,-14,-20,69,3,1
2012,TN,6,0,184383,241241,1,r,350159,171266,178893,725397,666946,58451,493229,99339,393890,725397,108624,147119,147356,117404,273367,149960,83587,39820,-8,11,18,0,-4,-11,20,-6,-14,-20,62,3,0
2012,TN,7,61679,182730,257306,1,r,320283,158756,161527,723286,610247,113039,476787,125395,351392,723286,121605,146949,140922,94606,265300,136260,78663,50377,-8,11,18,0,-4,-11,20,-6,-14,-20,67,3,0
2012,TN,8,79490,190923,279422,1,r,291193,141648,149545,705353,542072,163281,473736,131284,342452,705353,99919,142627,143526,106983,259816,129220,75498,55098,-8,11,18,0,-4,-11,20,-6,-14,-20,74,3,1
2012,TN,9,188422,59742,250987,1,d,380293,181597,198696,718017,202928,515089,448084,100501,347583,718017,149313,138403,131064,68872,265315,167153,70371,27791,-8,11,18,0,-4,-11,20,-6,-14,-20,78,3,0
2012,TX,1,67222,178322,249658,1,r,412421,201671,210750,710704,545549,165155,453625,84037,369588,710704,120566,130320,130748,107125,254680,143875,72921,37884,-8,11,18,0,-4,-11,20,-6,-14,-20,61,3,0
2012,TX,10,95710,159783,264019,1,r,339870,169845,170025,708122,557935,150187,460122,163211,296911,708122,120321,152198,135068,75361,254679,103119,77418,74142,-8,11,18,0,-4,-11,20,-6,-14,-20,50,3,0
2012,TX,11,41970,177742,226023,1,r,375699,188652,187047,718201,636755,81446,464321,87205,377116,718201,123708,129611,131461,110102,260514,133745,78752,48017,-8,11,18,0,-4,-11,20,-6,-14,-20,43,3,0
2012,TX,12,66080,175649,247712,1,r,351131,173305,177826,728142,588954,139188,472988,131955,341033,728142,139021,147733,132648,83830,269247,116404,90807,62036,-8,11,18,0,-4,-11,20,-6,-14,-20,51,3,0
2012,TX,13,0,187775,206388,1,r,363216,183968,179248,703835,609728,94107,452600,85834,366766,703835,126195,130218,128376,97079,259447,139085,78581,41781,-8,11,18,0,-4,-11,20,-6,-14,-20,47,3,-1
2012,TX,14,109697,131460,245839,0,r,335141,169728,165413,705051,504723,200328,466805,104814,361991,705051,122353,141702,141458,87851,256117,124141,74318,57658,-8,11,18,0,-4,-11,20,-6,-14,-20,59,3,0
2012,TX,15,89296,54056,146661,0,d,352858,174173,178685,719557,647606,71951,409161,74942,334219,719557,128957,137956,100758,71874,207329,123752,54490,29087,-8,11,18,0,-4,-11,20,-6,-14,-20,39,3,0
2012,TX,16,101403,51043,155005,0,d,290380,141793,148587,722987,599618,123369,433478,98129,335349,722987,136124,138941,112615,80648,232609,134308,65480,32821,-8,11,18,0,-4,-11,20,-6,-14,-20,40,3,0
2012,TX,17,0,143284,179262,1,r,393990,195740,198250,715138,540760,174378,432522,129108,303414,715138,157608,127898,117207,80284,259767,139876,75179,44712,-8,11,18,0,-4,-11,20,-6,-14,-20,53,3,0
2012,TX,18,146223,44015,194932,1,d,390151,193732,196419,732701,332340,400361,449600,84825,364775,732701,161055,145312,116288,61827,244986,151178,60453,33355,-8,11,18,0,-4,-11,20,-6,-14,-20,60,3,0
2012,TX,19,0,163239,192063,1,r,351241,179443,171798,707772,580703,127069,434533,91927,342606,707772,140807,125057,119700,91877,252354,142900,72335,37119,-8,11,18,0,-4,-11,20,-6,-14,-20,45,3,0
2012,TX,2,80512,159664,246328,1,r,346266,176034,170232,744871,542361,202510,491558,189583,301975,744871,158265,159663,132467,70995,264139,93339,78700,92100,-8,11,18,0,-4,-11,20,-6,-14,-20,49,3,1
2012,TX,20,119032,62376,186177,0,d,334919,163108,171811,722751,549757,172994,443147,96301,346846,722751,151068,140529,116392,75058,240903,130798,73297,36808,-8,11,18,0,-4,-11,20,-6,-14,-20,41,3,0
2012,TX,21,109326,187015,308865,1,r,315655,154234,161421,733779,638513,95266,501400,224065,277335,733779,146272,146283,137548,105708,301426,129763,91449,80214,-8,11,18,0,-4,-11,20,-6,-14,-20,44,3,1
2012,TX,22,80203,160668,250911,1,r,260484,128082,132402,750796,473969,276827,475360,195705,279655,750796,129933,172015,136142,63630,243507,69412,74431,99664,-8,11,18,0,-4,-11,20,-6,-14,-20,51,3,0
2012,TX,23,96676,87547,192169,0,r,323168,165194,157974,717598,603487,114111,434972,93468,341504,717598,122977,139015,122222,80788,224101,117074,65659,41368,-8,11,18,0,-4,-11,20,-6,-14,-20,40,3,0
2012,TX,24,87645,148586,243489,1,r,369422,179768,189654,732439,499834,232605,490881,207505,283376,732439,154922,165191,134155,66800,291899,117344,90338,84217,-8,11,18,0,-4,-11,20,-6,-14,-20,51,3,0
2012,TX,25,98827,154245,263932,0,d,321951,157783,164168,730018,610172,119846,462990,153151,309839,730018,125695,149439,129642,87407,252267,111264,75701,65302,-8,11,18,0,-4,-11,20,-6,-14,-20,51,3,0
2012,TX,26,74237,176642,258723,1,r,324852,160433,164419,750127,609347,140780,467596,181498,286098,750127,130654,180870,126071,57754,254716,80911,83668,90137,-8,11,18,0,-4,-11,20,-6,-14,-20,51,3,-1
2012,TX,27,83395,120684,212651,0,r,344744,171001,173743,709879,595358,114521,465624,80272,385352,709879,117415,133449,140971,100441,255614,132676,76027,46911,-8,11,18,0,-4,-11,20,-6,-14,-20,43,3,-1
2012,TX,28,112456,49309,165645,1,d,349593,171492,178101,732432,631313,101119,417584,73704,343880,732432,125438,139041,108178,70873,211478,120630,61723,29125,-8,11,18,0,-4,-11,20,-6,-14,-20,40,3,0
2012,TX,29,86053,0,95611,1,d,353177,177270,175907,695573,489327,206246,397638,34512,363126,695573,146915,135915,102133,48402,203709,133028,50962,19719,-8,11,18,0,-4,-11,20,-6,-14,-20,43,3,-1
2012,TX,3,0,187180,187180,1,r,288534,143174,145360,747284,541741,205543,484428,246540,237888,747284,124162,182659,134181,66168,265685,79626,75880,110179,-8,11,18,0,-4,-11,20,-6,-14,-20,53,3,0
2012,TX,30,171059,41222,217014,1,d,387343,190254,197089,727909,309730,418179,445634,84453,361181,727909,140981,147918,125830,62336,241604,141280,69928,30396,-8,11,18,0,-4,-11,20,-6,-14,-20,62,3,0
2012,TX,31,82977,145348,237187,1,r,303224,150670,152554,739975,577541,162434,469027,150202,318825,739975,146235,159972,122115,73874,250758,101231,86948,62579,-8,11,18,0,-4,-11,20,-6,-14,-20,53,3,0
2012,TX,32,99288,146653,251636,1,r,346469,172430,174039,733807,474508,259299,481771,201119,280652,733807,143545,161055,128003,81592,273812,112670,82549,78593,-8,11,18,0,-4,-11,20,-6,-14,-20,51,3,1
2012,TX,33,85114,30252,117375,0,,390766,198337,192429,703750,478503,225247,408990,38160,370830,703750,140745,141020,100473,57630,212902,147576,51874,13452,-8,11,18,0,-4,-11,20,-6,-14,-20,46,3,-1
2012,TX,34,89606,52448,144778,0,,349733,171729,178004,716416,637682,78734,420832,60797,360035,716416,120183,130634,113574,88551,210218,137134,49637,23447,-8,11,18,0,-4,-11,20,-6,-14,-20,38,3,0
2012,TX,35,105626,52894,165179,0,,411983,205785,206198,745662,535012,210650,446921,81629,365292,745662,174250,142929,113852,60698,241585,150211,64020,27354,-8,11,18,0,-4,-11,20,-6,-14,-20,44,3,-1
2012,TX,36,62143,165405,233832,0,,370008,185520,184488,714368,573247,141121,465784,84851,380933,714368,124515,142325,140011,91583,252710,118949,79363,54398,-8,11,18,0,-4,-11,20,-6,-14,-20,52,3,0
2012,TX,4,60214,182679,250343,1,r,354649,172517,182132,705523,580698,124825,469821,91094,378727,705523,102291,140501,140712,108232,261218,141860,75477,43881,-8,11,18,0,-4,-11,20,-6,-14,-20,59,3,1
2012,TX,5,69178,134091,208230,1,r,390395,194788,195607,711115,536795,174320,451838,78741,373097,711115,127939,138930,124675,86324,243948,136655,69516,37777,-8,11,18,0,-4,-11,20,-6,-14,-20,54,3,0
2012,TX,6,98053,145019,249936,1,r,314561,153838,160723,720861,507973,212888,456876,135672,321204,720861,132206,152005,132299,69034,255030,106747,88638,59645,-8,11,18,0,-4,-11,20,-6,-14,-20,58,3,0
2012,TX,7,85553,142793,234837,1,r,343596,169118,174478,717354,496838,220516,474129,223345,250784,717354,144228,161085,132077,65917,276050,104905,75942,95203,-8,11,18,0,-4,-11,20,-6,-14,-20,50,3,1
2012,TX,8,51051,194043,251052,1,r,372733,190234,182499,743782,620887,122895,485439,134516,350923,743782,123896,157920,140550,88389,247489,102975,76838,67676,-8,11,18,0,-4,-11,20,-6,-14,-20,51,3,0
2012,TX,9,144075,36139,183566,1,d,342734,170161,172573,738924,286906,452018,450384,107210,343174,738924,155775,152787,120422,61680,242462,145347,66855,30260,-8,11,18,0,-4,-11,20,-6,-14,-20,58,3,0
2012,UT,1,60611,175487,245528,1,r,304601,152836,151765,711806,634744,77062,405987,112993,292994,711806,139834,129809,106132,64699,227512,96998,82686,47828,-8,11,18,0,-4,-11,20,-6,-14,-20,43,3,0
2012,UT,2,83176,154523,248545,0,d,339280,170764,168516,703528,606691,96837,427377,130710,296667,703528,146612,122487,105870,84998,236486,115238,78132,43116,-8,11,18,0,-4,-11,20,-6,-14,-20,44,3,1
2012,UT,3,60719,198828,259547,1,r,280995,140071,140924,711258,648930,62328,387320,145269,242051,711258,153077,118608,100836,64205,208883,83201,73071,52611,-8,11,18,0,-4,-11,20,-6,-14,-20,42,3,0
2012,UT,4,119803,119035,245277,0,,341677,173128,168549,728695,624543,104152,420651,115549,305102,728695,152347,139544,101049,57980,222810,91449,85814,45547,-8,11,18,0,-4,-11,20,-6,-14,-20,44,3,0
2012,VA,1,147036,200845,356806,1,r,246889,122128,124761,747797,551535,196262,494619,172718,321901,747797,126431,156306,144361,97881,261115,86541,80294,94280,-8,11,18,0,-4,-11,20,-6,-14,-20,65,3,1
2012,VA,10,142024,214038,366444,1,r,263397,130407,132990,758321,554932,203389,494387,263188,231199,758321,110238,179294,151113,74485,251931,51009,64833,136089,-8,11,18,0,-4,-11,20,-6,-14,-20,53,3,2
2012,VA,11,202606,117902,332243,1,d,275610,136134,139476,770944,460649,310295,515910,270355,245555,770944,149050,173413,144848,75417,262616,50380,82975,129261,-8,11,18,0,-4,-11,20,-6,-14,-20,54,3,2
2012,VA,2,142548,166231,309222,1,r,275155,136736,138419,721969,481541,240428,475741,143288,332453,721969,158868,138769,134889,87245,273166,118979,90369,63818,-8,11,18,0,-4,-11,20,-6,-14,-20,68,3,1
2012,VA,3,259199,58931,318936,1,d,308012,148712,159300,751694,269464,482230,476432,107295,369137,751694,171913,136189,133610,84852,284200,171093,78695,34412,-8,11,18,0,-4,-11,20,-6,-14,-20,78,3,1
2012,VA,4,150190,199292,350046,1,r,292405,144239,148166,741349,456092,285257,494434,121283,373151,741349,115188,161519,153280,90332,260923,105009,92635,63279,-8,11,18,0,-4,-11,20,-6,-14,-20,74,3,0
2012,VA,5,149214,193009,348111,1,r,350227,169195,181032,726296,542575,183721,499787,122668,377119,726296,109883,137890,153654,127133,284304,151737,82274,50293,-8,11,18,0,-4,-11,20,-6,-14,-20,75,3,2
2012,VA,6,111949,211278,323893,1,r,393693,190898,202795,737755,621653,116102,494387,131145,363242,737755,120576,138092,147837,119466,289972,154048,90517,45407,-8,11,18,0,-4,-11,20,-6,-14,-20,68,3,1
2012,VA,7,158012,222983,381909,1,r,327052,157837,169215,738355,570670,167685,503006,198387,304619,738355,109788,160306,150033,104366,274633,92935,94350,87348,-8,11,18,0,-4,-11,20,-6,-14,-20,66,3,1
2012,VA,8,226847,107370,351187,1,d,343358,168508,174850,767596,490792,276804,555906,333695,222211,767596,197694,178276,137109,73924,303335,72733,88107,142495,-8,11,18,0,-4,-11,20,-6,-14,-20,54,3,3
2012,VA,9,116400,184882,301658,1,r,391983,194880,197103,723791,661164,62627,500157,87482,412675,723791,107344,141807,151421,127032,292772,181929,80978,29865,-8,11,18,0,-4,-11,20,-6,-14,-20,67,3,1
2012,VT,1,208600,67543,289931,1,d,198840,98206,100634,626011,595252,30759,434948,155505,279443,626011,93470,122276,143883,98489,258520,121221,87303,49996,-8,11,18,0,-4,-11,20,-6,-14,-20,56,3,1
2012,WA,1,177025,151187,328212,0,d,273395,137309,136086,691738,563619,128119,466737,179590,287147,691738,112613,155328,142920,78252,252605,77627,82537,92441,-8,11,18,0,-4,-11,20,-6,-14,-20,47,3,0
2012,WA,10,163036,115381,278417,0,,252381,124120,128261,688615,522860,165755,452227,111627,340600,688615,135820,132211,129674,88257,262324,115309,94245,52770,-8,11,18,0,-4,-11,20,-6,-14,-20,54,3,0
2012,WA,2,184826,117465,302291,1,d,270971,134894,136077,689226,556946,132280,467877,136136,331741,689226,134612,134653,139155,95911,269022,117210,91972,59840,-8,11,18,0,-4,-11,20,-6,-14,-20,49,3,0
2012,WA,3,116438,177446,293884,0,r,264974,131641,133333,686267,598005,88262,462237,107614,354623,686267,107389,136789,141360,101049,259109,125338,85121,48650,-8,11,18,0,-4,-11,20,-6,-14,-20,47,3,0
2012,WA,4,78940,154749,233689,1,r,348996,176222,172774,695040,529559,165481,423943,79426,344517,695040,117506,127573,120599,84042,231753,118463,73007,40283,-8,11,18,0,-4,-11,20,-6,-14,-20,40,3,1
2012,WA,5,117512,191066,308578,0,r,289725,144691,145034,678303,601888,76415,444671,120347,324324,678303,117658,125113,136016,98356,266942,146607,80086,40249,-8,11,18,0,-4,-11,20,-6,-14,-20,50,3,0
2012,WA,6,186661,129725,316386,0,d,224178,112864,111314,687387,560609,126778,482033,129085,352948,687387,117358,130390,149462,115076,266680,126238,86844,53598,-8,11,18,0,-4,-11,20,-6,-14,-20,54,3,1
2012,WA,7,298368,76212,374580,1,d,292674,144047,148627,696589,532925,163664,517880,287013,230867,696589,175968,149431,137009,91034,316847,121075,93937,101835,-8,11,18,0,-4,-11,20,-6,-14,-20,53,3,1
2012,WA,8,121886,180204,302090,1,r,266877,133332,133545,690250,557335,132915,454729,140995,313734,690250,108613,154469,142793,71591,246207,85699,79091,81417,-8,11,18,0,-4,-11,20,-6,-14,-20,48,3,0
2012,WA,9,192034,76105,268139,1,d,266791,133795,132996,693597,379166,314431,473525,179682,293843,693597,140951,152878,129807,84050,265328,110218,79749,75361,-8,11,18,0,-4,-11,20,-6,-14,-20,55,3,1
2012,WI,1,158414,200423,365058,1,r,281592,140091,141501,713436,632783,80653,481650,125659,355991,713436,108087,146428,150757,98735,274550,120583,95854,58113,-8,11,18,0,-4,-11,20,-6,-14,-20,54,3,0
2012,WI,2,265422,124683,390898,0,d,353018,175751,177267,729417,637092,92325,485193,182877,302316,729417,143290,145221,143604,90096,297146,133012,97830,66304,-8,11,18,0,-4,-11,20,-6,-14,-20,57,3,1
2012,WI,3,217712,121713,339764,1,d,293687,147532,146155,712440,671642,40798,467985,108425,359560,712440,122314,129106,144265,108918,282612,150716,90589,41307,-8,11,18,0,-4,-11,20,-6,-14,-20,54,3,0
2012,WI,4,235257,80787,325788,1,d,352142,168651,183491,715059,375427,339632,440118,113934,326184,715059,152702,133839,118514,72522,281126,171156,76846,33124,-8,11,18,0,-4,-11,20,-6,-14,-20,67,3,1
2012,WI,5,118478,250335,369664,0,r,262676,128760,133916,716218,663357,52861,496053,172093,323960,716218,110183,144649,154858,109313,288965,116894,97595,74476,-8,11,18,0,-4,-11,20,-6,-14,-20,50,3,0
2012,WI,6,135921,223460,359745,1,r,293777,147197,146580,709482,661696,47786,493474,124549,368925,709482,109536,141324,151918,114173,285816,135315,99883,50618,-8,11,18,0,-4,-11,20,-6,-14,-20,52,3,0
2012,WI,7,157524,201720,359669,0,r,280880,141512,139368,711054,668736,42318,500389,103766,396623,711054,99307,138231,157862,125401,294277,155026,97433,41818,-8,11,18,0,-4,-11,20,-6,-14,-20,51,3,0
2012,WI,8,156287,198874,355464,1,r,321008,160442,160566,719292,656833,62459,489308,114850,374458,719292,110688,144824,150257,104872,283870,134383,98108,51379,-8,11,18,0,-4,-11,20,-6,-14,-20,50,3,-1
2012,WV,1,80342,133809,214151,1,r,306052,150767,155285,614520,583257,31263,422691,83509,339182,614520,102597,115930,129827,102962,243018,146599,69626,26793,-8,11,18,0,-4,-11,20,-6,-14,-20,66,3,1
2012,WV,2,68560,158206,226766,1,r,237972,117202,120770,627517,579627,47890,441305,92246,349059,627517,92169,127700,139139,103014,251763,135682,76810,39271,-8,11,18,0,-4,-11,20,-6,-14,-20,67,3,1
2012,WV,3,108199,92238,200437,1,d,187950,91896,96054,613376,575264,38112,432205,65929,366276,613376,98470,119114,135336,105128,246763,156951,65911,23901,-8,11,18,0,-4,-11,20,-6,-14,-20,73,3,1
2012,WY,1,57573,166452,250700,1,r,274876,139598,135278,576412,523798,52614,380942,94278,286664,576412,103983,107860,117953,75050,223513,101188,75892,46433,-8,11,18,0,-4,-11,20,-6,-14,-20,46,3,0
2014,AK,1,114602,142572,279741,1,r,241984,126647,115337,736732,483584,253148,465149,130264,334885,736732,155304,141263,140212,69899,249659,84449,80517,84693,-16,4,9,-5,-6,-16,11,-11,-16,-22,29,-8,-4
2014,AL,1,48278,103758,152234,0,r,287732,139220,148512,696783,468456,228327,471948,108866,363082,696783,113176,132458,140570,113016,255303,142084,71662,41557,-16,4,9,-5,-6,-16,11,-11,-16,-22,69,-8,-4
2014,AL,2,54692,113103,167952,1,r,335443,163641,171802,678622,443780,234842,452170,97705,354465,678622,120219,129837,130262,105469,258138,148447,71305,38386,-16,4,9,-5,-6,-16,11,-11,-16,-22,70,-8,-3
2014,AL,3,52816,103558,156620,1,r,380744,186384,194360,706574,492627,213947,467933,95582,372351,706574,119322,139967,135309,105875,270971,158922,73725,38324,-16,4,9,-5,-6,-16,11,-11,-16,-22,69,-8,-3
2014,AL,4,0,132831,134752,1,r,396815,194937,201878,683372,596472,86900,466499,76111,390388,683372,101778,133790,138266,117390,259439,156506,71786,31147,-16,4,9,-5,-6,-16,11,-11,-16,-22,52,-8,-3
2014,AL,5,0,115338,154974,1,r,319630,155354,164276,706373,542208,164165,481062,141723,339339,706373,122211,139430,144083,106010,274891,139169,76477,59245,-16,4,9,-5,-6,-16,11,-11,-16,-22,62,-8,-3
2014,AL,6,42291,135945,178449,0,r,360995,175745,185250,696788,552743,144045,479767,165982,313785,696788,115055,141894,138650,106530,265000,115293,83161,66546,-16,4,9,-5,-6,-16,11,-11,-16,-22,59,-8,-3
2014,AL,7,133687,0,135899,1,d,369687,171376,198311,680865,223987,456878,437387,78438,358949,680865,130169,121458,128328,92222,257475,176613,57627,23235,-16,4,9,-5,-6,-16,11,-11,-16,-22,75,-8,-4
2014,AR,1,63555,124139,196256,1,r,379294,186690,192604,723492,570516,152976,489049,76664,412385,723492,113024,138337,138741,125713,282699,179878,73359,29462,-16,4,9,-5,-6,-16,11,-11,-16,-22,70,-8,-4
2014,AR,2,103477,123073,237330,0,r,407212,197260,209952,756326,552349,203977,501483,141846,359637,756326,142223,145570,141740,107177,285873,150843,85507,49523,-16,4,9,-5,-6,-16,11,-11,-16,-22,64,-8,-4
2014,AR,3,0,151630,190935,1,r,400018,197738,202280,767904,661353,106551,493179,122669,370510,767904,139883,148016,136232,104556,283989,154751,79775,49463,-16,4,9,-5,-6,-16,11,-11,-16,-22,32,-8,-4
2014,AR,4,87742,110789,206131,0,r,390094,192540,197554,718647,538254,180393,484703,79779,404924,718647,106522,133100,143356,127566,278727,173869,74785,30073,-16,4,9,-5,-6,-16,11,-11,-16,-22,66,-8,-4
2014,AZ,1,97391,87723,185114,1,d,333449,167767,165682,739373,486153,253220,476163,110423,365740,739373,116835,131087,136058,120886,249074,129311,76925,42838,-16,4,9,-5,-6,-16,11,-11,-16,-22,29,-8,-3
2014,AZ,2,109543,109704,219351,1,d,283757,141001,142756,713036,580233,132803,492761,164822,327939,713036,126986,124531,140184,139664,292370,151531,86568,54271,-16,4,9,-5,-6,-16,11,-11,-16,-22,29,-8,-2
2014,AZ,3,58192,46185,104428,1,d,321820,161537,160283,757119,562263,194856,443974,71568,372406,757119,146516,139601,117344,81001,234874,139833,69044,25997,-16,4,9,-5,-6,-16,11,-11,-16,-22,29,-8,-4
2014,AZ,4,45179,122560,175179,1,r,353012,178459,174553,734258,650401,83857,535038,101406,433632,734258,98252,118447,148905,191506,282598,159588,84861,38149,-16,4,9,-5,-6,-16,11,-11,-16,-22,29,-8,-3
2014,AZ,5,54596,124867,179463,1,r,286784,140534,146250,781441,670857,110584,504377,169711,334666,781441,118294,155905,133545,121024,269256,100893,87401,80962,-16,4,9,-5,-6,-16,11,-11,-16,-22,28,-8,-4
2014,AZ,6,70198,129578,199776,1,r,354476,171772,182704,737185,633444,103741,530224,224843,305381,737185,127943,151577,153028,123006,299053,120693,89880,88480,-16,4,9,-5,-6,-16,11,-11,-16,-22,26,-8,-3
2014,AZ,7,54235,0,72454,0,d,390372,194948,195424,763089,480612,282477,430363,59778,370585,763089,162200,146686,109337,53047,224388,147620,55708,21060,-16,4,9,-5,-6,-16,11,-11,-16,-22,32,-8,-4
2014,AZ,8,0,128710,169776,1,r,251160,118412,132748,760904,640193,120711,534549,146678,387871,760904,111397,144905,145875,154715,284913,120326,94776,69811,-16,4,9,-5,-6,-16,11,-11,-16,-22,33,-8,-3
2014,AZ,9,88609,67841,162062,1,d,386274,199823,186451,745079,569179,175900,488777,173063,315714,745079,180386,144966,127962,85908,292217,142705,88294,61218,-16,4,9,-5,-6,-16,11,-11,-16,-22,31,-8,-3
2014,CA,1,84320,132052,216372,0,r,285100,143058,142042,710428,609675,100753,495413,118280,377133,710428,119577,118508,152298,139511,273795,145836,77864,50095,-16,4,9,-5,-6,-16,11,-11,-16,-22,27,-8,-3
2014,CA,10,55123,70582,125705,0,r,302395,149709,152686,732084,537662,194422,455639,80481,375158,732084,132823,144252,126676,83750,228743,102757,75229,50757,-16,4,9,-5,-6,-16,11,-11,-16,-22,25,-8,-4
2014,CA,11,117502,57160,174662,0,d,296008,143774,152234,739693,458725,280968,512839,213003,299836,739693,124572,152729,152938,111746,268357,89433,75859,103065,-16,4,9,-5,-6,-16,11,-11,-16,-22,26,-8,-3
2014,CA,12,160067,32197,192264,1,d,241208,123315,117893,736123,367300,368823,588294,327144,261150,736123,203351,171946,137413,106978,318240,105950,72038,140252,-16,4,9,-5,-6,-16,11,-11,-16,-22,15,-8,-3
2014,CA,13,168491,21940,190431,1,d,298040,143444,154596,743310,331662,411648,512368,234022,278346,743310,168916,156343,136513,92962,282191,113608,73623,94960,-16,4,9,-5,-6,-16,11,-11,-16,-22,33,-8,-2
2014,CA,14,114389,34757,149146,1,d,251935,123998,127937,753002,347939,405063,537041,243546,293495,753002,141330,164719,151194,108974,249842,64271,64867,120704,-16,4,9,-5,-6,-16,11,-11,-16,-22,14,-8,-3
2014,CA,15,99756,43150,142906,1,d,266381,132531,133850,753911,360146,393765,518302,209629,308673,753911,130503,169580,147134,94419,245929,67501,65298,113130,-16,4,9,-5,-6,-16,11,-11,-16,-22,17,-8,-3
2014,CA,16,46277,44943,91220,1,d,327027,162972,164055,718849,409083,309766,416021,49839,366182,718849,138589,131262,107858,73473,207675,129631,51886,26158,-16,4,9,-5,-6,-16,11,-11,-16,-22,27,-8,-4
2014,CA,17,134408,0,134408,1,d,284734,142164,142570,756995,250694,506301,527626,286566,241060,756995,159463,175568,131884,86689,248336,54074,62084,132178,-16,4,9,-5,-6,-16,11,-11,-16,-22,8,-8,-1
2014,CA,18,133060,63326,196386,1,d,273399,137205,136194,734378,478871,255507,514763,307451,207312,734378,118046,161979,150701,105697,269816,64051,62647,143118,-16,4,9,-5,-6,-16,11,-11,-16,-22,14,-8,-1
2014,CA,19,127788,0,127788,1,d,246829,124497,122332,746211,352028,394183,495206,162690,332516,746211,143802,160791,140007,86993,221998,69623,57664,94711,-16,4,9,-5,-6,-16,11,-11,-16,-22,17,-8,-4
2014,CA,2,163124,54400,217524,1,d,328656,163214,165442,720049,574227,145822,516041,204775,311266,720049,108498,139576,164768,129623,280016,112481,75778,91757,-16,4,9,-5,-6,-16,11,-11,-16,-22,25,-8,-3
2014,CA,20,106034,0,141044,1,d,389887,196901,192986,732074,569208,162866,459444,123950,335494,732074,138157,137601,132895,86320,222810,93841,67820,61149,-16,4,9,-5,-6,-16,11,-11,-16,-22,25,-8,-3
2014,CA,21,33470,45907,79377,1,r,367920,193013,174907,712295,507568,204727,406453,28886,377567,712295,151466,132222,104204,56320,181929,117024,45011,19894,-16,4,9,-5,-6,-16,11,-11,-16,-22,27,-8,-5
2014,CA,22,37289,96053,133342,1,r,296477,147324,149153,739418,538102,201316,445903,103566,342337,739418,138771,133771,123356,85553,235530,113310,70978,51242,-16,4,9,-5,-6,-16,11,-11,-16,-22,26,-8,-4
2014,CA,23,33726,100317,134043,1,r,304916,153209,151707,747914,566921,180993,463132,89513,373619,747914,141301,139654,127414,86903,240106,110450,71465,58191,-16,4,9,-5,-6,-16,11,-11,-16,-22,31,-8,-4
2014,CA,24,103228,95566,198794,1,d,383015,192111,190904,726519,589206,137313,460726,151266,309460,726519,132376,123576,133678,111451,248895,100742,76145,72008,-16,4,9,-5,-6,-16,11,-11,-16,-22,25,-8,-3
2014,CA,25,0,114072,114072,0,r,222792,108500,114292,718796,454790,264006,455714,119557,336157,718796,116020,150735,139364,75750,220969,79018,70869,71082,-16,4,9,-5,-6,-16,11,-11,-16,-22,29,-8,-4
2014,CA,26,87176,82653,169829,1,d,299616,148354,151262,725795,583740,142055,473793,151940,321853,725795,127857,140117,139070,98519,228883,75908,72714,80261,-16,4,9,-5,-6,-16,11,-11,-16,-22,24,-8,-3
2014,CA,27,75728,51852,127580,1,d,218192,106334,111858,714911,283221,431690,513327,209194,304133,714911,128803,150858,148761,116157,239911,91744,68303,79864,-16,4,9,-5,-6,-16,11,-11,-16,-22,14,-8,-3
2014,CA,28,91996,0,120264,1,d,247733,123699,124034,721435,482278,239157,547313,239112,308201,721435,177313,160714,137513,103760,292855,129813,78066,84976,-16,4,9,-5,-6,-16,11,-11,-16,-22,20,-8,-4
2014,CA,29,50096,17045,67141,0,d,299097,151242,147855,718633,398751,319882,460398,82520,377878,718633,160569,147704,121447,72146,201576,104667,61668,35241,-16,4,9,-5,-6,-16,11,-11,-16,-22,26,-8,-6
2014,CA,3,79224,71036,150260,1,d,280859,140282,140577,720104,470612,249492,461728,111775,349953,720104,134747,134566,134512,93212,245160,109696,74339,61125,-16,4,9,-5,-6,-16,11,-11,-16,-22,26,-8,-3
2014,CA,30,86568,45315,131883,1,d,221188,109865,111323,754331,503027,251304,533567,226615,306952,754331,145960,161638,149839,110173,276791,101274,78914,96603,-16,4,9,-5,-6,-16,11,-11,-16,-22,25,-8,-4
2014,CA,31,51622,48162,99784,0,r,277272,135998,141274,738321,456059,282262,451284,103808,347476,738321,154455,141211,122221,72239,217372,103182,62427,51763,-16,4,9,-5,-6,-16,11,-11,-16,-22,30,-8,-3
2014,CA,32,50353,34053,84406,1,d,254619,125652,128967,735945,333747,402198,480548,96129,384419,735945,138182,149108,134374,95253,198676,87091,60330,51255,-16,4,9,-5,-6,-16,11,-11,-16,-22,22,-8,-5
2014,CA,33,108331,74700,183031,0,d,215044,104433,110611,714411,533125,181286,521423,333756,187667,714411,129174,151857,144207,118886,297852,79094,66656,152102,-16,4,9,-5,-6,-16,11,-11,-16,-22,17,-8,-2
2014,CA,34,61621,0,61621,1,d,347294,175682,171612,720406,307589,412817,483225,116516,366709,720406,164682,159969,118923,78323,239711,153066,56557,30088,-16,4,9,-5,-6,-16,11,-11,-16,-22,22,-8,-5
2014,CA,35,62255,0,62255,0,d,304903,154335,150568,732845,351243,381602,441060,61206,379854,732845,154845,151036,118337,60573,185910,85469,63598,36843,-16,4,9,-5,-6,-16,11,-11,-16,-22,28,-8,-5
2014,CA,36,72682,61457,134139,1,d,341515,170245,171270,746522,509325,237197,499548,103741,395807,746522,116547,133239,130886,145615,261820,143560,71856,46404,-16,4,9,-5,-6,-16,11,-11,-16,-22,28,-8,-3
2014,CA,37,96787,18051,114838,1,d,325076,156240,168836,723724,323503,400221,496720,184045,312675,723724,170092,153671,129435,88926,271981,136515,71408,64058,-16,4,9,-5,-6,-16,11,-11,-16,-22,38,-8,-3
2014,CA,38,58192,40288,98480,1,d,248835,121723,127112,720208,356390,363818,476194,99432,376762,720208,139498,145917,131809,96491,203362,81777,67797,53788,-16,4,9,-5,-6,-16,11,-11,-16,-22,23,-8,-5
2014,CA,39,41906,91319,133225,1,r,226535,111265,115270,716854,381654,335200,477219,189335,287884,716854,132190,146021,140016,96278,219406,70122,64813,84471,-16,4,9,-5,-6,-16,11,-11,-16,-22,16,-8,-4
2014,CA,4,0,211134,211134,1,r,263718,132208,131510,719688,620463,99225,512992,164062,348930,719688,94425,138103,160962,137704,267604,99731,82111,85762,-16,4,9,-5,-6,-16,11,-11,-16,-22,22,-8,-4
2014,CA,40,49379,0,49379,1,d,339679,167956,171723,713940,387047,326893,421698,38925,382773,713940,145596,145809,111232,55925,179453,110069,51075,18309,-16,4,9,-5,-6,-16,11,-11,-16,-22,27,-8,-5
2014,CA,41,46948,35936,82884,1,d,299802,149029,150773,739287,391578,347709,435655,65149,370506,739287,150994,141385,118762,66896,191499,86408,66154,38937,-16,4,9,-5,-6,-16,11,-11,-16,-22,30,-8,-4
2014,CA,42,38850,74540,113390,1,r,260371,129110,131261,754191,507575,246616,478216,115917,362299,754191,135257,155896,134298,85783,219885,74632,73442,71811,-16,4,9,-5,-6,-16,11,-11,-16,-22,28,-8,-4
2014,CA,43,69681,28521,98202,1,d,313413,149970,163443,731916,275481,456435,475266,115238,360028,731916,147734,149428,128643,82190,240996,123724,68469,48803,-16,4,9,-5,-6,-16,11,-11,-16,-22,38,-8,-5
2014,CA,44,59670,0,68862,1,d,322862,160028,162834,726147,329140,397007,432835,48031,384804,726147,157521,138797,116481,61865,184112,98784,54796,30532,-16,4,9,-5,-6,-16,11,-11,-16,-22,33,-8,-5
2014,CA,45,56819,106083,162902,0,r,250681,122039,128642,763368,485882,277486,518162,267579,250583,763368,131076,162323,150423,102060,265906,70268,71148,124490,-16,4,9,-5,-6,-16,11,-11,-16,-22,15,-8,-3
2014,CA,46,49738,33577,83315,1,d,332972,169028,163944,730783,441838,288945,448006,79715,368291,730783,159867,149748,113578,64460,187247,85170,63151,38926,-16,4,9,-5,-6,-16,11,-11,-16,-22,22,-8,-5
2014,CA,47,69091,54309,123400,0,d,250424,123008,127416,718747,409600,309147,484613,143874,340739,718747,137341,153191,137762,89115,242825,104757,69982,68086,-16,4,9,-5,-6,-16,11,-11,-16,-22,22,-8,-4
2014,CA,48,62713,112082,174795,0,r,216462,107249,109213,726491,473787,252704,523123,229571,293552,726491,136058,148876,154114,115597,268779,80990,75743,112046,-16,4,9,-5,-6,-16,11,-11,-16,-22,15,-8,-3
2014,CA,49,64981,98161,163142,1,r,271423,137220,134203,728456,582666,145790,482657,212543,270114,728456,133572,149307,134476,103754,251417,82160,69964,99293,-16,4,9,-5,-6,-16,11,-11,-16,-22,24,-8,-3
2014,CA,5,129613,0,171148,1,d,276345,133588,142757,722814,468352,254462,497276,157770,339506,722814,129579,135604,148928,115118,265421,101943,84501,78977,-16,4,9,-5,-6,-16,11,-11,-16,-22,27,-8,-4
2014,CA,50,45302,111997,157299,1,r,316055,158737,157318,737332,572093,165239,488174,137100,351074,737332,129270,142947,143558,102746,239592,94904,75314,69374,-16,4,9,-5,-6,-16,11,-11,-16,-22,25,-8,-4
2014,CA,51,56373,25577,81950,1,d,294389,149040,145349,720935,464135,256800,439562,61344,378218,720935,160959,135158,112424,76301,194825,112206,53117,29502,-16,4,9,-5,-6,-16,11,-11,-16,-22,28,-8,-6
2014,CA,52,98826,92746,191572,0,d,267669,135021,132648,759602,523582,236020,524637,303752,220885,759602,172454,153448,141187,96469,282394,83197,77846,121351,-16,4,9,-5,-6,-16,11,-11,-16,-22,17,-8,-3
2014,CA,53,87104,60940,148044,1,d,271812,133525,138287,753810,492579,261231,516761,184837,331924,753810,177295,149040,135837,94491,265815,102346,86881,76588,-16,4,9,-5,-6,-16,11,-11,-16,-22,27,-8,-4
2014,CA,6,97008,36448,133456,1,d,269656,131873,137783,737671,379085,358586,473539,123773,349766,737671,160853,142674,124567,83495,264422,140520,73155,50747,-16,4,9,-5,-6,-16,11,-11,-16,-22,31,-8,-4
2014,CA,7,92521,91066,183587,1,d,195167,95237,99930,736555,486767,249788,499117,162986,336131,736555,132072,145936,146648,104127,258041,97056,80515,80470,-16,4,9,-5,-6,-16,11,-11,-16,-22,25,-8,-4
2014,CA,8,37056,77480,114536,1,r,264334,130813,133521,715953,541202,174751,442481,69745,372736,715953,126744,129157,129768,91372,231229,122113,70899,38217,-16,4,9,-5,-6,-16,11,-11,-16,-22,33,-8,-3
2014,CA,9,63475,57729,121204,1,d,280729,139530,141199,738320,403121,335199,461250,91471,369779,738320,124156,143117,133581,90961,230743,106222,67166,57355,-16,4,9,-5,-6,-16,11,-11,-16,-22,28,-8,-4
2014,CO,1,183281,80682,278494,1,d,386104,193224,192880,788694,630280,158414,555283,245747,309536,788694,201204,167694,135571,87451,332241,145739,98784,87718,-16,4,9,-5,-6,-16,11,-11,-16,-22,35,-8,-3
2014,CO,2,196300,149645,345945,1,d,325359,165642,159717,765721,695480,70241,510400,268859,241541,765721,151676,148402,157460,100906,300661,107586,93772,99303,-16,4,9,-5,-6,-16,11,-11,-16,-22,24,-8,-3
2014,CO,3,100364,163011,281141,1,r,389312,195098,194214,729368,643028,86340,497871,152715,345156,729368,122232,134947,152256,115912,282857,141709,87121,54027,-16,4,9,-5,-6,-16,11,-11,-16,-22,27,-8,-4
2014,CO,4,83727,185292,286507,0,r,365727,184332,181395,768242,683435,84807,498558,163580,334978,768242,124865,159086,148393,96036,272870,103729,88430,80711,-16,4,9,-5,-6,-16,11,-11,-16,-22,27,-8,-4
2014,CO,5,105673,157182,262855,1,r,303534,154611,148923,759664,613785,145879,496820,171853,324967,759664,150903,144602,143178,96351,283910,123506,93125,67279,-16,4,9,-5,-6,-16,11,-11,-16,-22,37,-8,-3
2014,CO,6,118847,143467,276440,1,r,326512,161444,165068,772966,575067,197899,506049,212430,293619,772966,137344,170403,141003,85399,277454,95307,89302,92845,-16,4,9,-5,-6,-16,11,-11,-16,-22,36,-8,-4
2014,CO,7,148225,120918,269143,1,d,369161,184869,184292,771211,679306,91905,519482,159028,360454,771211,153229,155290,147917,97517,289599,117317,97756,74526,-16,4,9,-5,-6,-16,11,-11,-16,-22,26,-8,-3
2014,CT,1,127430,78609,217881,1,d,255622,123250,132372,711205,502787,208418,495550,178908,316642,711205,116397,139431,152163,114464,279974,109415,83870,86689,-16,4,9,-5,-6,-16,11,-11,-16,-22,45,-8,-3
2014,CT,2,131294,80837,227936,1,d,247336,123113,124223,710798,612355,98443,487416,165040,322376,710798,110230,137965,155416,114850,267479,93295,87944,86240,-16,4,9,-5,-6,-16,11,-11,-16,-22,37,-8,-2
2014,CT,3,130009,69454,209939,1,d,305023,145712,159311,720986,539395,181591,497046,178345,318701,720986,131493,136499,147750,112824,278098,116079,77356,84663,-16,4,9,-5,-6,-16,11,-11,-16,-22,44,-8,-2
2014,CT,4,101401,88209,198800,1,d,316025,154177,161848,740215,536542,203673,496358,243812,252546,740215,112467,155338,152408,102522,262907,80884,63911,118112,-16,4,9,-5,-6,-16,11,-11,-16,-22,39,-8,-2
2014,CT,5,106256,92404,213301,0,d,309752,152758,156994,713473,572870,140603,495448,174009,321439,713473,108555,146726,154172,110868,267359,101239,79152,86968,-16,4,9,-5,-6,-16,11,-11,-16,-22,35,-8,-2
2014,DC,1,0,0,0,0,,333932,158445,175487,658893,265077,393816,463211,254672,208539,658893,186305,131272,107263,74465,277378,106661,68949,101768,-16,4,9,-5,-6,-16,11,-11,-16,-22,64,-8,0
2014,DE,1,137251,85146,231617,0,d,374667,181806,192861,935614,647533,288081,640343,195881,444462,935614,158220,175804,188816,153759,349743,147902,109829,92012,-16,4,9,-5,-6,-16,11,-11,-16,-22,57,-8,-3
2014,FL,1,54976,165086,235343,1,r,263389,133452,129937,743897,571711,172186,502782,136106,366676,743897,141972,136654,145128,116518,271005,132549,87718,50738,-16,4,9,-5,-6,-16,11,-11,-16,-22,53,-8,-4
2014,FL,10,89426,143128,232574,1,r,283777,139053,144724,758350,591441,166909,537054,156378,380676,758350,132457,147097,143384,143887,280952,135303,88697,56952,-16,4,9,-5,-6,-16,11,-11,-16,-22,40,-8,-4
2014,FL,11,90786,181508,272294,1,r,202796,98204,104592,728133,629693,98440,560802,106121,454681,728133,82245,110350,148159,239116,297719,177325,87626,32768,-16,4,9,-5,-6,-16,11,-11,-16,-22,48,-8,-4
2014,FL,12,0,1,1,1,r,218938,105537,113401,729937,642401,87536,529434,149228,380206,729937,97087,145178,151069,157114,281737,138462,82625,60650,-16,4,9,-5,-6,-16,11,-11,-16,-22,36,-8,-4
2014,FL,13,0,168172,223576,0,r,261432,127036,134396,707503,610496,97007,541077,155356,385721,707503,102973,132386,162232,167042,310672,170541,87412,52719,-16,4,9,-5,-6,-16,11,-11,-16,-22,38,-8,-4
2014,FL,14,1,0,1,1,d,318973,154123,164850,757963,474776,283187,518607,139936,378671,757963,162053,156399,139077,96569,290566,162018,79953,48595,-16,4,9,-5,-6,-16,11,-11,-16,-22,47,-8,-4
2014,FL,15,84832,128750,213582,1,r,282388,137633,144755,724176,538561,185615,475964,124741,351223,724176,130583,136950,139225,105177,255190,128297,77031,49862,-16,4,9,-5,-6,-16,11,-11,-16,-22,45,-8,-4
2014,FL,16,105483,169126,274829,1,r,309746,148611,161135,744076,658645,85431,567986,178813,389173,744076,89231,121029,156132,223476,311660,149057,96035,66568,-16,4,9,-5,-6,-16,11,-11,-16,-22,41,-8,-3
2014,FL,17,82263,141493,223756,1,r,323555,162637,160918,725251,608499,116752,530421,101196,429225,725251,94976,120002,144293,193295,275502,159354,80244,35904,-16,4,9,-5,-6,-16,11,-11,-16,-22,41,-8,-3
2014,FL,18,151478,101896,253374,1,d,267365,128603,138762,731704,591226,140478,546401,149814,396587,731704,99273,134647,156845,177066,292179,138326,89428,64425,-16,4,9,-5,-6,-16,11,-11,-16,-22,47,-8,-3
2014,FL,19,80824,159354,246861,0,r,357725,172121,185604,753542,652444,101098,572268,179198,393070,753542,98267,120683,154614,220177,303652,144801,94075,64776,-16,4,9,-5,-6,-16,11,-11,-16,-22,40,-8,-3
2014,FL,2,126096,123262,249780,0,r,300530,152202,148328,711296,493170,218126,468036,125283,342753,711296,141796,131587,135822,103379,262789,147467,70679,44643,-16,4,9,-5,-6,-16,11,-11,-16,-22,63,-8,-3
2014,FL,20,128498,28968,157466,1,d,282637,137296,145341,745656,307618,438038,500358,89795,410563,745656,146409,146025,140015,104708,244629,152702,66493,25434,-16,4,9,-5,-6,-16,11,-11,-16,-22,62,-8,-5
2014,FL,21,153395,0,153970,1,d,249378,120062,129316,742664,579711,162953,527982,185787,342195,742664,101256,136944,140918,172588,275199,121234,83578,70387,-16,4,9,-5,-6,-16,11,-11,-16,-22,41,-8,-3
2014,FL,22,125404,90685,216096,1,d,321226,161786,159440,731165,585590,145575,553956,208827,345129,731165,124445,143330,154614,156483,307349,143942,84093,79314,-16,4,9,-5,-6,-16,11,-11,-16,-22,42,-8,-3
2014,FL,23,103269,61519,164788,1,d,238102,115877,122225,730033,565313,164720,519367,188738,330629,730033,118567,162341,146112,119038,278160,129757,77129,71274,-16,4,9,-5,-6,-16,11,-11,-16,-22,36,-8,-3
2014,FL,24,129192,15239,149918,1,d,255917,122367,133550,741950,266289,475661,496285,100007,396278,741950,154181,155074,135423,89089,230890,143717,57066,30107,-16,4,9,-5,-6,-16,11,-11,-16,-22,59,-8,-4
2014,FL,25,0,1,1,1,r,271432,133229,138203,745358,637143,108215,515627,137014,378613,745358,126120,163328,139821,117022,223881,112730,66840,44311,-16,4,9,-5,-6,-16,11,-11,-16,-22,30,-8,-4
2014,FL,26,78306,83031,161337,1,d,221219,108535,112684,749692,646991,102701,523591,137892,385699,749692,130157,152427,152454,118445,218812,102842,67992,47978,-16,4,9,-5,-6,-16,11,-11,-16,-22,31,-8,-4
2014,FL,27,0,1,1,1,r,291727,141485,150242,760443,663711,96732,536317,156595,379722,760443,133010,168162,142116,124315,247862,135983,59843,52036,-16,4,9,-5,-6,-16,11,-11,-16,-22,30,-8,-3
2014,FL,3,73910,148691,228809,0,r,249392,124758,124634,716034,573217,142817,478377,117410,360967,716034,122934,128743,138121,122179,261176,140442,78314,42420,-16,4,9,-5,-6,-16,11,-11,-16,-22,49,-8,-3
2014,FL,4,0,177887,227253,1,r,253224,124542,128682,714880,554431,160449,493504,150741,342763,714880,143004,140625,140370,102171,272496,125545,85172,61779,-16,4,9,-5,-6,-16,11,-11,-16,-22,47,-8,-4
2014,FL,5,112340,59237,171577,1,d,292959,138779,154180,742217,288736,453481,478867,77257,401610,742217,158884,140305,137325,85080,260285,174358,64864,21063,-16,4,9,-5,-6,-16,11,-11,-16,-22,65,-8,-5
2014,FL,6,99563,166254,265817,0,r,252570,123700,128870,736069,627765,108304,542155,147449,394706,736069,99475,129132,162608,173836,286085,146623,85244,54218,-16,4,9,-5,-6,-16,11,-11,-16,-22,48,-8,-3
2014,FL,7,73011,144474,227164,1,r,253606,124623,128983,735643,588945,146698,493138,165934,327204,735643,134961,142813,143824,103551,256554,124593,76402,55559,-16,4,9,-5,-6,-16,11,-11,-16,-22,39,-8,-4
2014,FL,8,93724,180728,274513,1,r,250449,121958,128491,715672,596149,119523,530123,143339,386784,715672,96045,124488,159888,171342,285836,149048,85909,50879,-16,4,9,-5,-6,-16,11,-11,-16,-22,47,-8,-3
2014,FL,9,93850,74963,173878,1,d,292135,143238,148897,769993,569188,200805,500717,121549,379168,769993,146798,171276,130036,88291,245209,134005,76246,34958,-16,4,9,-5,-6,-16,11,-11,-16,-22,33,-8,-5
2014,GA,1,61175,95337,156512,0,r,340083,167740,172343,729328,454517,274811,472358,118269,354089,729328,144158,136769,131902,95698,264770,137621,80011,47138,-16,4,9,-5,-6,-16,11,-11,-16,-22,66,-8,-3
2014,GA,10,65777,130703,196480,0,r,261956,126196,135760,713570,489442,224128,457611,110786,346825,713570,109227,142992,133989,98899,243617,126756,71928,44933,-16,4,9,-5,-6,-16,11,-11,-16,-22,65,-8,-3
2014,GA,11,0,161532,161532,0,r,342318,167394,174924,725169,530232,194937,479911,186176,293735,725169,135324,156471,136840,79383,270931,101246,89056,80629,-16,4,9,-5,-6,-16,11,-11,-16,-22,52,-8,-4
2014,GA,12,75478,91336,166814,0,d,271493,133935,137558,701628,412025,289603,447891,89875,358016,701628,127577,129344,128906,92884,244477,146221,66611,31645,-16,4,9,-5,-6,-16,11,-11,-16,-22,68,-8,-3
2014,GA,13,159445,0,159445,1,d,285052,134663,150389,741383,253307,488076,465146,122993,342153,741383,125247,166214,134651,70861,248292,119966,83092,45234,-16,4,9,-5,-6,-16,11,-11,-16,-22,66,-8,-4
2014,GA,14,0,118782,118782,1,r,358694,175791,182903,700856,596031,104825,458438,79752,378686,700856,114392,144428,130539,94751,248795,133974,76183,38638,-16,4,9,-5,-6,-16,11,-11,-16,-22,48,-8,-4
2014,GA,2,96363,66537,162900,0,d,327593,161076,166517,685342,294263,391079,440601,76942,363659,685342,127577,125548,127457,94595,245947,159202,61448,25297,-16,4,9,-5,-6,-16,11,-11,-16,-22,71,-8,-3
2014,GA,3,0,156277,156277,1,r,291612,142158,149454,725530,503728,221802,468134,114625,353509,725530,118956,145385,135312,98916,257294,129032,78317,49945,-16,4,9,-5,-6,-16,11,-11,-16,-22,64,-8,-4
2014,GA,4,161211,0,161320,0,d,287345,138284,149061,728367,228266,500101,473266,142672,330594,728367,128501,156669,141469,74242,251970,134265,76303,41402,-16,4,9,-5,-6,-16,11,-11,-16,-22,65,-8,-3
2014,GA,5,170326,0,170326,1,d,354116,170098,184018,738016,244573,493443,488762,196160,292602,738016,183104,148572,122118,77417,287587,158064,70439,59084,-16,4,9,-5,-6,-16,11,-11,-16,-22,68,-8,-2
2014,GA,6,71486,139018,210504,1,r,331737,164117,167620,732089,518393,213696,497415,288397,209018,732089,125230,174538,140651,80113,275326,86271,79205,109850,-16,4,9,-5,-6,-16,11,-11,-16,-22,37,-8,-3
2014,GA,7,60112,113557,173669,1,r,312928,153261,159667,752996,442553,310443,484689,190541,294148,752996,129569,175763,139237,67003,242595,93623,77860,71112,-16,4,9,-5,-6,-16,11,-11,-16,-22,39,-8,-4
2014,GA,8,0,129938,130057,1,r,353841,172719,181122,705698,456101,249597,459741,93468,366273,705698,119193,137250,131117,100371,254286,152004,68037,34245,-16,4,9,-5,-6,-16,11,-11,-16,-22,68,-8,-3
2014,GA,9,34988,146059,181047,1,r,386144,189933,196211,717371,620486,96885,482445,99944,382501,717371,108156,140173,138073,123737,251634,134237,76957,40440,-16,4,9,-5,-6,-16,11,-11,-16,-22,43,-8,-3
2014,HI,1,93390,86454,182268,0,d,244536,123357,121179,707541,131131,576410,496762,165447,331315,707541,145979,135089,130512,121155,231099,75544,77587,77968,-16,4,9,-5,-6,-16,11,-11,-16,-22,5,-8,-4
2014,HI,2,142010,33630,187435,1,d,233338,118105,115233,712020,229580,482440,477824,136892,340932,712020,133205,130624,139489,106906,219670,82724,72766,64180,-16,4,9,-5,-6,-16,11,-11,-16,-22,8,-8,-4
2014,IA,1,141145,147762,289306,0,d,369653,182718,186935,770612,704896,65716,514067,133810,380257,770612,125685,138633,153633,126918,311138,138769,110059,62310,-16,4,9,-5,-6,-16,11,-11,-16,-22,44,-8,-4
2014,IA,2,143431,129455,273329,1,d,378904,189424,189480,776785,701868,74917,516153,145675,370478,776785,132153,143258,154161,122458,308412,151293,100116,57003,-16,4,9,-5,-6,-16,11,-11,-16,-22,39,-8,-3
2014,IA,3,119109,148814,282066,0,r,355012,175043,179969,801039,722087,78952,532546,171543,361003,801039,144744,159458,152145,108317,312956,129706,104018,79232,-16,4,9,-5,-6,-16,11,-11,-16,-22,38,-8,-5
2014,IA,4,105504,169834,275633,1,r,439672,220560,219112,758690,708907,49783,499968,119398,380570,758690,117560,129077,151546,132935,308965,155313,102269,51383,-16,4,9,-5,-6,-16,11,-11,-16,-22,29,-8,-4
2014,ID,1,77277,143580,220864,1,r,382812,189829,192983,834295,777990,56305,548528,126171,422357,834295,128595,157153,158795,129721,304513,156017,98426,50070,-16,4,9,-5,-6,-16,11,-11,-16,-22,25,-8,-4
2014,ID,2,82801,131492,214293,1,r,378643,190862,187781,800169,720117,80052,496665,135351,361314,800169,145012,143750,139209,105258,287074,150702,88765,47607,-16,4,9,-5,-6,-16,11,-11,-16,-22,26,-8,-4
2014,IL,1,162268,59749,222017,1,d,269024,126961,142063,717741,294595,423146,477646,132459,345187,717741,122630,135447,143961,105059,265021,135442,77318,52261,-16,4,9,-5,-6,-16,11,-11,-16,-22,68,-8,-3
2014,IL,10,91136,95992,187128,0,d,259290,128606,130684,711698,549483,162215,466907,205323,261584,711698,108975,145653,141947,94581,244599,82217,70896,91486,-16,4,9,-5,-6,-16,11,-11,-16,-22,27,-8,-2
2014,IL,11,93436,81335,174772,1,d,282625,137320,145305,712657,452899,259758,451249,157772,293477,712657,127476,155955,130233,69102,236716,85272,75969,75475,-16,4,9,-5,-6,-16,11,-11,-16,-22,36,-8,-3
2014,IL,12,87860,110038,209738,1,d,269281,132374,136907,701698,553900,147798,477514,100097,377417,701698,122886,133639,142745,108711,273446,147393,79569,46484,-16,4,9,-5,-6,-16,11,-11,-16,-22,65,-8,-3
2014,IL,13,86935,123337,210272,1,r,374429,182240,192189,715374,581452,133922,458137,136661,321476,715374,138583,125689,132017,107646,285134,150162,86148,48824,-16,4,9,-5,-6,-16,11,-11,-16,-22,53,-8,-3
2014,IL,14,76861,145369,222230,1,r,223339,111170,112169,725522,634856,90666,477309,187433,289876,725522,96884,160418,152733,90878,252091,67601,80477,104013,-16,4,9,-5,-6,-16,11,-11,-16,-22,28,-8,-4
2014,IL,15,55652,166274,221926,1,r,276589,139041,137548,705504,657420,48084,482304,87984,394320,705504,111352,129552,145952,122508,274400,141129,88787,44484,-16,4,9,-5,-6,-16,11,-11,-16,-22,54,-8,-4
2014,IL,16,63810,153388,217198,1,r,273071,134324,138747,699582,633351,66231,473726,103325,370401,699582,109520,131982,144646,115902,268332,122751,87665,57916,-16,4,9,-5,-6,-16,11,-11,-16,-22,40,-8,-3
2014,IL,17,110560,88785,199361,1,d,312849,154551,158298,701014,572850,128164,473419,87076,386343,701014,108953,129710,139565,120998,280965,155815,84716,40434,-16,4,9,-5,-6,-16,11,-11,-16,-22,53,-8,-4
2014,IL,18,62377,184363,246740,1,r,303284,151104,152180,710629,649094,61535,485462,155084,330378,710629,115921,134339,146620,119333,282923,119321,95088,68514,-16,4,9,-5,-6,-16,11,-11,-16,-22,39,-8,-4
2014,IL,2,160337,43799,204266,0,d,257503,120736,136767,707817,275773,432044,468390,106290,362100,707817,118157,137626,145863,97870,258513,138903,74964,44646,-16,4,9,-5,-6,-16,11,-11,-16,-22,68,-8,-3
2014,IL,3,116764,64091,180855,1,d,256832,125680,131152,730269,560358,169911,487347,127923,359424,730269,125283,149922,141521,99695,245112,100825,79614,64673,-16,4,9,-5,-6,-16,11,-11,-16,-22,28,-8,-3
2014,IL,4,79666,22278,101944,0,d,353991,178964,175027,725616,424266,301350,457419,98772,358647,725616,166384,148319,112265,64015,223752,123055,64127,36570,-16,4,9,-5,-6,-16,11,-11,-16,-22,28,-8,-4
2014,IL,5,116364,56350,184019,1,d,250342,123039,127303,717666,585330,132336,515029,272680,242349,717666,194860,151061,122326,84881,294812,100899,88976,104937,-16,4,9,-5,-6,-16,11,-11,-16,-22,24,-8,-3
2014,IL,6,78465,160287,238752,1,r,217334,107522,109812,734700,613230,121470,503940,256131,247809,734700,105518,153185,164283,102513,265609,69258,77398,118953,-16,4,9,-5,-6,-16,11,-11,-16,-22,21,-8,-3
2014,IL,7,155110,27168,182278,1,d,319236,153151,166085,727478,243309,484169,487710,191943,295767,727478,185056,139369,122198,83693,286948,140016,73120,73812,-16,4,9,-5,-6,-16,11,-11,-16,-22,59,-8,-2
2014,IL,8,84178,66878,151056,1,d,306984,153500,153484,725320,493417,231903,489863,159450,330413,725320,138462,155696,137739,87525,253238,95885,90733,66620,-16,4,9,-5,-6,-16,11,-11,-16,-22,23,-8,-4
2014,IL,9,141000,72384,213450,1,d,207071,100654,106417,710295,514862,195433,505705,267004,238701,710295,128056,148827,140761,112944,280810,112159,79297,89354,-16,4,9,-5,-6,-16,11,-11,-16,-22,30,-8,-2
2014,IN,1,86579,51000,142293,1,d,236391,115594,120797,718064,502079,215985,482300,106250,376050,718064,117077,141656,145762,105429,265908,126642,86004,53262,-16,4,9,-5,-6,-16,11,-11,-16,-22,54,-8,-4
2014,IN,2,55590,85583,145200,1,r,382120,188198,193922,721627,624564,97063,471483,98750,372733,721627,117942,136352,140542,106025,268091,141633,88497,37961,-16,4,9,-5,-6,-16,11,-11,-16,-22,46,-8,-3
2014,IN,3,39771,97892,148793,1,r,299688,148047,151641,734384,639346,95038,476392,109332,367060,734384,120704,138721,141911,104775,278743,139102,98439,41202,-16,4,9,-5,-6,-16,11,-11,-16,-22,47,-8,-4
2014,IN,4,47056,94998,142054,1,r,371704,185907,185797,742958,667284,75674,478535,117851,360684,742958,126571,142069,140400,105754,277447,134118,93582,49747,-16,4,9,-5,-6,-16,11,-11,-16,-22,37,-8,-3
2014,IN,5,49756,105277,161440,0,r,302000,146327,155673,743454,637700,105754,499880,219459,280421,743454,125970,155449,144246,100486,290210,112456,94385,83369,-16,4,9,-5,-6,-16,11,-11,-16,-22,46,-8,-4
2014,IN,6,45509,102187,155071,1,r,382133,188642,193491,720106,671660,48446,483388,98665,384723,720106,112379,139206,146092,116610,280605,145864,89420,45321,-16,4,9,-5,-6,-16,11,-11,-16,-22,46,-8,-3
2014,IN,7,61443,46887,112261,1,d,411554,199347,212207,756223,460140,296083,483696,105521,378175,756223,161339,146196,134018,80135,282965,174449,76346,32170,-16,4,9,-5,-6,-16,11,-11,-16,-22,61,-8,-4
2014,IN,8,61384,103344,171315,1,r,276657,137784,138873,723064,666492,56572,485565,93541,392024,723064,115290,136029,146543,114920,281213,151162,87165,42886,-16,4,9,-5,-6,-16,11,-11,-16,-22,53,-8,-3
2014,IN,9,55016,101594,163387,1,r,346422,169668,176754,736975,678125,58850,481677,121233,360444,736975,125779,140139,143008,107360,277557,137774,91292,48491,-16,4,9,-5,-6,-16,11,-11,-16,-22,39,-8,-3
2014,KS,1,65397,138764,204161,1,r,360807,182791,178016,718346,628657,89689,453908,110420,343488,718346,130694,119925,128640,111280,274215,143091,90650,40474,-16,4,9,-5,-6,-16,11,-11,-16,-22,33,-8,-4
2014,KS,2,87153,128742,225686,1,r,352881,175720,177161,715446,626053,89393,465448,127682,337766,715446,123976,127784,138186,111015,277280,140066,90445,46769,-16,4,9,-5,-6,-16,11,-11,-16,-22,46,-8,-3
2014,KS,3,89584,134493,224077,1,r,342291,167638,174653,749250,610852,138398,493297,222408,270889,749250,134455,152286,140909,92995,285307,108185,89997,87125,-16,4,9,-5,-6,-16,11,-11,-16,-22,40,-8,-3
2014,KS,4,69396,138757,208153,1,r,304754,151244,153510,720979,600576,120403,468868,132574,336294,720979,125761,132209,136994,102243,272478,132112,87201,53165,-16,4,9,-5,-6,-16,11,-11,-16,-22,40,-8,-4
2014,KY,1,63596,173022,236618,1,r,396252,196733,199519,724041,645577,78464,486161,75192,410969,724041,115478,133389,145432,120648,282156,173149,77389,31618,-16,4,9,-5,-6,-16,11,-11,-16,-22,62,-8,-3
2014,KY,2,69898,156936,226834,1,r,370525,181932,188593,742858,664275,78583,489945,92715,397230,742858,122462,145358,145525,107519,277832,149208,86230,42394,-16,4,9,-5,-6,-16,11,-11,-16,-22,54,-8,-3
2014,KY,3,157056,87981,247355,1,d,347235,167356,179879,736532,531206,205326,504994,156411,348583,736532,139317,143355,147478,107350,300489,157073,87636,55780,-16,4,9,-5,-6,-16,11,-11,-16,-22,63,-8,-2
2014,KY,4,71694,150464,222158,1,r,333610,165224,168386,748191,692270,55921,501074,127526,373548,748191,122770,151115,152398,103184,275723,127823,84730,63170,-16,4,9,-5,-6,-16,11,-11,-16,-22,47,-8,-3
2014,KY,5,47617,171350,218967,1,r,311358,155658,155700,712274,688429,23845,493599,57402,436197,712274,113539,142920,149480,115986,278624,194576,63723,20325,-16,4,9,-5,-6,-16,11,-11,-16,-22,52,-8,-1
2014,KY,6,98290,147404,245694,0,r,396114,194636,201478,749561,636504,113057,491408,150455,340953,749561,138386,150046,144754,98335,297270,156132,87283,53855,-16,4,9,-5,-6,-16,11,-11,-16,-22,54,-8,-3
2014,LA,1,46047,189250,244004,1,r,339190,164687,174503,796858,630097,166761,536740,156230,380510,796858,146810,150927,158293,113868,294038,135231,88162,70645,-16,4,9,-5,-6,-16,11,-11,-16,-22,51,-8,-4
2014,LA,2,190006,0,221570,1,d,356399,171871,184528,775807,249041,526766,520472,116809,403663,775807,164604,150184,150535,94688,292635,182484,67561,42590,-16,4,9,-5,-6,-16,11,-11,-16,-22,72,-8,-3
2014,LA,3,0,207926,236268,0,r,367783,179534,188249,777665,550804,226861,505548,102983,402565,777665,146754,144882,147465,101238,286954,150634,78031,58289,-16,4,9,-5,-6,-16,11,-11,-16,-22,68,-8,-5
2014,LA,4,0,152683,207919,1,r,337591,166762,170829,756663,463426,293237,494302,92065,402237,756663,133816,141112,140911,111255,276860,163765,70021,43074,-16,4,9,-5,-6,-16,11,-11,-16,-22,70,-8,-4
2014,LA,5,75006,247211,326073,0,r,382005,189979,192026,750819,462421,288398,492166,84511,407655,750819,129739,140963,143344,112164,271296,171185,63291,36820,-16,4,9,-5,-6,-16,11,-11,-16,-22,74,-8,-4
2014,LA,6,95127,234200,332888,0,r,378349,183617,194732,791864,563353,228511,511460,148998,362462,791864,154467,151923,148533,97957,296411,134355,86922,75134,-16,4,9,-5,-6,-16,11,-11,-16,-22,65,-8,-4
2014,MA,1,167612,0,227075,1,d,242890,116320,126570,733426,614854,118572,502469,144193,358276,733426,120959,137133,156079,120509,285689,140321,82411,62957,-16,4,9,-5,-6,-16,11,-11,-16,-22,38,-8,-2
2014,MA,2,169640,0,235813,1,d,284700,140251,144449,736475,624547,111928,490255,180590,309665,736475,124798,141063,155114,104634,271530,107793,81578,82159,-16,4,9,-5,-6,-16,11,-11,-16,-22,33,-8,-3
2014,MA,3,139104,81638,230789,1,d,253326,125007,128319,755778,579456,176322,511618,189467,322151,755778,124077,157054,157240,101327,270944,99642,77415,93887,-16,4,9,-5,-6,-16,11,-11,-16,-22,25,-8,-2
2014,MA,4,184158,0,255297,1,d,229532,110855,118677,748190,653912,94278,507275,247004,260271,748190,109157,156714,161185,108530,273453,78291,74111,121051,-16,4,9,-5,-6,-16,11,-11,-16,-22,27,-8,-2
2014,MA,5,182100,0,256486,0,d,341574,164919,176655,755944,592584,163360,532387,288082,244305,755944,145935,157950,146286,112437,291331,92003,78109,121219,-16,4,9,-5,-6,-16,11,-11,-16,-22,26,-8,-1
2014,MA,6,149638,111989,278919,0,d,283135,137094,146041,757309,648304,109005,534362,229160,305202,757309,114501,151471,171749,123052,286188,89847,79628,116713,-16,4,9,-5,-6,-16,11,-11,-16,-22,31,-8,-3
2014,MA,7,142133,0,176077,1,d,334794,162539,172255,769929,395110,374819,506051,217662,288389,769929,224565,141361,115787,74933,281429,131521,72259,77649,-16,4,9,-5,-6,-16,11,-11,-16,-22,47,-8,-2
2014,MA,8,200644,0,261781,1,d,254630,122686,131944,751768,586750,165018,540852,239110,301742,751768,148216,149436,149872,121501,294978,98347,86281,110350,-16,4,9,-5,-6,-16,11,-11,-16,-22,40,-8,-3
2014,MA,9,140413,114971,264552,1,d,230168,110510,119658,736589,651903,84686,529082,181461,347621,736589,103410,139706,164854,148654,293794,120590,83131,90073,-16,4,9,-5,-6,-16,11,-11,-16,-22,41,-8,-3
2014,MD,1,73843,176342,250418,1,r,261680,128532,133148,728405,603248,125157,500524,151527,348997,728405,108820,137682,157793,125329,268746,98585,84372,85789,-16,4,9,-5,-6,-16,11,-11,-16,-22,57,-8,-3
2014,MD,2,120412,70411,196354,1,d,279500,134443,145057,743321,413514,329807,497527,146496,351031,743321,147155,147628,143629,93242,273842,112324,85523,75995,-16,4,9,-5,-6,-16,11,-11,-16,-22,61,-8,-3
2014,MD,3,128594,87029,215946,1,d,274814,129353,145461,768378,484512,283866,531399,248801,282598,768378,160980,150049,147562,106972,290531,87851,86055,116625,-16,4,9,-5,-6,-16,11,-11,-16,-22,51,-8,-2
2014,MD,4,134628,54217,191837,1,d,355702,170565,185137,742761,253917,488844,502612,157260,345352,742761,141195,158424,143230,89693,263670,84437,89528,89705,-16,4,9,-5,-6,-16,11,-11,-16,-22,63,-8,-3
2014,MD,5,144725,80752,226040,1,d,282450,139801,142649,753079,389615,363464,500701,169521,331180,753079,124399,156507,157140,91039,255049,64027,79035,111987,-16,4,9,-5,-6,-16,11,-11,-16,-22,62,-8,-2
2014,MD,6,94704,91930,190536,0,d,274347,136716,137631,755369,513374,241995,512815,213282,299533,755369,127124,162404,152203,98470,269094,90133,81286,97675,-16,4,9,-5,-6,-16,11,-11,-16,-22,36,-8,-1
2014,MD,7,144639,55860,206809,1,d,301251,144704,156547,738431,264827,473604,498561,186330,312231,738431,143751,142006,146463,101979,270119,118861,77495,73763,-16,4,9,-5,-6,-16,11,-11,-16,-22,66,-8,-1
2014,MD,8,136722,87859,225097,1,d,301673,145048,156625,746663,509575,237088,518674,280467,238207,746663,117429,154973,155485,115447,274387,68745,75502,130140,-16,4,9,-5,-6,-16,11,-11,-16,-22,36,-8,0
2014,ME,1,186674,94751,321987,1,d,251739,122145,129594,673835,636471,37364,486267,176043,310224,673835,102477,132574,153310,120918,279939,122588,92180,65171,-16,4,9,-5,-6,-16,11,-11,-16,-22,35,-8,-4
2014,ME,2,118568,133320,295009,0,d,251019,122659,128360,656254,623807,32447,473140,105738,367402,656254,94642,124540,154134,121646,269902,154707,80923,34272,-16,4,9,-5,-6,-16,11,-11,-16,-22,35,-8,-4
2014,MI,1,113263,130414,250131,1,r,280342,142787,137555,703687,649927,53760,506551,121155,385396,703687,99869,122347,163533,147970,287370,160092,89605,37673,-16,4,9,-5,-6,-16,11,-11,-16,-22,45,-8,-4
2014,MI,10,67143,157069,228692,1,r,175179,86992,88187,706525,657917,48608,491984,112985,378999,706525,99222,141461,158706,117268,269546,115011,91601,62934,-16,4,9,-5,-6,-16,11,-11,-16,-22,39,-8,-3
2014,MI,11,101681,140435,251238,0,r,239726,118019,121707,718435,593200,125235,501166,228865,272301,718435,110357,151649,158256,103432,274567,87632,87570,99365,-16,4,9,-5,-6,-16,11,-11,-16,-22,28,-8,-2
2014,MI,12,134346,64716,206660,0,d,258832,126799,132033,705207,554225,150982,456570,152460,304110,705207,139139,131633,132137,94924,269662,128064,82481,59117,-16,4,9,-5,-6,-16,11,-11,-16,-22,45,-8,-1
2014,MI,13,132710,27234,166947,0,d,266473,126443,140030,687170,264609,422561,441215,61422,379793,687170,127088,129940,132327,88274,257008,174350,60812,21846,-16,4,9,-5,-6,-16,11,-11,-16,-22,71,-8,-4
2014,MI,14,165272,41801,212468,0,d,244791,114981,129810,687921,237568,450353,465008,140803,324205,687921,119834,130082,142896,107078,268709,154374,68009,46326,-16,4,9,-5,-6,-16,11,-11,-16,-22,69,-8,-2
2014,MI,2,70851,135568,213072,1,r,338751,165748,173003,724843,615780,109063,468466,119821,348645,724843,125398,132946,142211,102443,268751,136338,89177,43236,-16,4,9,-5,-6,-16,11,-11,-16,-22,42,-8,-4
2014,MI,3,84720,125754,217165,1,r,307942,153636,154306,725487,609903,115584,480389,139374,341015,725487,127908,140532,141732,99236,267811,125304,89363,53144,-16,4,9,-5,-6,-16,11,-11,-16,-22,51,-8,-4
2014,MI,4,85777,123962,219423,0,r,324205,162241,161964,702630,661426,41204,470683,98328,372355,702630,108586,126316,146466,122134,269433,148589,80918,39926,-16,4,9,-5,-6,-16,11,-11,-16,-22,40,-8,-4
2014,MI,5,148182,69222,222138,1,d,220209,106190,114019,687292,531937,155355,470958,90747,380211,687292,109774,129209,145071,116369,281383,164140,80973,36270,-16,4,9,-5,-6,-16,11,-11,-16,-22,63,-8,-4
2014,MI,6,84391,116801,208976,1,r,336019,164533,171486,712100,604262,107838,470680,125411,345269,712100,124469,129538,144361,111036,276704,145241,84466,46997,-16,4,9,-5,-6,-16,11,-11,-16,-22,52,-8,-3
2014,MI,7,92083,119564,223685,1,r,275957,138444,137513,702894,642782,60112,484344,108714,375630,702894,104847,137615,154419,114367,272507,126681,90358,55468,-16,4,9,-5,-6,-16,11,-11,-16,-22,48,-8,-3
2014,MI,8,102269,132739,243125,0,r,313913,153884,160029,725201,619643,105558,464655,178144,286511,725201,114376,141439,149749,93893,272435,109570,82064,80801,-16,4,9,-5,-6,-16,11,-11,-16,-22,39,-8,-2
2014,MI,9,136342,81470,225757,1,d,249274,121495,127779,720485,573407,147078,507856,149110,358746,720485,130643,145058,151508,112643,298688,146698,91361,60629,-16,4,9,-5,-6,-16,11,-11,-16,-22,57,-8,-3
2014,MN,1,122851,103536,226695,1,d,303383,150838,152545,666946,610937,56009,445655,119513,326142,666946,112795,120108,132257,107149,261328,114101,91646,55581,-16,4,9,-5,-6,-16,11,-11,-16,-22,34,-8,-4
2014,MN,2,95565,137778,245848,1,r,223960,110601,113359,689759,587696,102063,454071,171562,282509,689759,111628,145372,138330,83333,254262,74907,88005,91350,-16,4,9,-5,-6,-16,11,-11,-16,-22,35,-8,-4
2014,MN,3,101846,167515,269585,1,r,237765,115386,122379,685736,557031,128705,476770,227797,248973,685736,112609,139856,150416,96580,268815,81754,80936,106125,-16,4,9,-5,-6,-16,11,-11,-16,-22,35,-8,-4
2014,MN,4,147857,79492,241637,1,d,243097,118470,124627,695920,501721,194199,461314,196537,264777,695920,139121,128879,132983,91498,267760,110049,80315,77396,-16,4,9,-5,-6,-16,11,-11,-16,-22,34,-8,-3
2014,MN,5,167079,56577,236010,1,d,311757,155386,156371,706584,490587,215997,479872,208913,270959,706584,177797,138838,121429,78468,293412,137508,85703,70201,-16,4,9,-5,-6,-16,11,-11,-16,-22,48,-8,-3
2014,MN,6,90926,133328,236846,0,r,225500,114167,111333,684784,627024,57760,441893,132359,309534,684784,113601,144947,133411,74673,242232,78738,85910,77584,-16,4,9,-5,-6,-16,11,-11,-16,-22,38,-8,-5
2014,MN,7,130546,109955,240835,1,d,319467,160365,159102,662682,613159,49523,447578,95469,352109,662682,99951,114268,136525,122176,267071,128215,92789,46067,-16,4,9,-5,-6,-16,11,-11,-16,-22,34,-8,-5
2014,MN,8,129090,125358,266083,0,d,221609,112393,109216,664762,618804,45958,465430,106384,359046,664762,100212,119265,146890,123956,274315,132684,93348,48283,-16,4,9,-5,-6,-16,11,-11,-16,-22,39,-8,-4
2014,MO,1,119315,35273,163494,1,d,340717,161477,179240,744782,329319,415463,498470,154624,343846,744782,154724,140316,146236,92404,307630,181491,84259,41880,-16,4,9,-5,-6,-16,11,-11,-16,-22,71,-8,-2
2014,MO,2,75384,148191,231117,1,r,257931,123932,133999,758288,679555,78733,536092,257233,278859,758288,119275,145959,162293,132448,297764,98076,92852,106836,-16,4,9,-5,-6,-16,11,-11,-16,-22,31,-8,-3
2014,MO,3,52021,130940,191620,1,r,287181,142623,144558,766993,709357,57636,513773,122428,391345,766993,127652,151606,154845,111362,283399,120925,102867,59607,-16,4,9,-5,-6,-16,11,-11,-16,-22,52,-8,-4
2014,MO,4,46464,120014,176286,1,r,357334,177851,179483,763003,677735,85268,489284,117738,371546,763003,135677,136483,142513,116009,283862,153474,89281,41107,-16,4,9,-5,-6,-16,11,-11,-16,-22,49,-8,-3
2014,MO,5,79256,69071,153635,1,d,342142,165675,176467,758442,510277,248165,511452,134770,376682,758442,147384,142890,146732,107562,307730,171865,89926,45939,-16,4,9,-5,-6,-16,11,-11,-16,-22,60,-8,-4
2014,MO,6,55157,124616,186970,1,r,258986,128877,130109,760291,691037,69254,509267,135105,374162,760291,121769,149974,151702,114924,285617,131067,95293,59257,-16,4,9,-5,-6,-16,11,-11,-16,-22,47,-8,-4
2014,MO,7,47282,104054,163957,1,r,380597,186716,193881,765669,708459,57210,508430,116447,391983,765669,133638,141310,145894,124610,299852,174124,87378,38350,-16,4,9,-5,-6,-16,11,-11,-16,-22,37,-8,-4
2014,MO,8,38721,106124,159224,0,r,383049,190618,192431,746121,684532,61589,509999,82366,427633,746121,114731,137568,153847,132571,288955,176854,81428,30673,-16,4,9,-5,-6,-16,11,-11,-16,-22,58,-8,-3
2014,MS,1,43713,102622,151111,1,r,409847,198936,210911,760275,528166,232109,498091,95676,402415,760275,121188,149987,141263,111512,282173,162995,81350,37828,-16,4,9,-5,-6,-16,11,-11,-16,-22,71,-8,-4
2014,MS,2,100688,0,148646,1,d,343607,164760,178847,722640,227787,494853,461029,86512,374517,722640,121641,135781,135208,96434,255841,169973,59322,26546,-16,4,9,-5,-6,-16,11,-11,-16,-22,77,-8,-3
2014,MS,3,47744,117771,170946,1,r,393708,192514,201194,749430,459890,289540,493488,124596,368892,749430,126359,142663,143328,112016,280938,158274,73594,49070,-16,4,9,-5,-6,-16,11,-11,-16,-22,73,-8,-3
2014,MS,4,37869,108776,155576,1,r,319032,157409,161623,761734,545352,216382,498102,104169,393933,761734,126147,147625,143788,107351,276871,159837,81774,35260,-16,4,9,-5,-6,-16,11,-11,-16,-22,68,-8,-3
2014,MT,1,148690,203871,367963,0,r,417056,209188,207868,1023579,914571,109008,695850,203839,492011,1023579,174095,180800,216621,170153,410962,218580,122384,69998,-16,4,9,-5,-6,-16,11,-11,-16,-22,28,-8,-4
2014,NC,1,154333,55990,210323,1,d,450102,214041,236061,742851,290863,451988,493346,96872,396474,742851,135254,135079,145390,114038,286254,191868,68024,26362,-16,4,9,-5,-6,-16,11,-11,-16,-22,69,-8,-4
2014,NC,10,85292,133504,218796,1,r,368371,177702,190669,744808,607265,137543,518349,121492,396857,744808,110977,149880,155436,128002,283641,163351,80838,39452,-16,4,9,-5,-6,-16,11,-11,-16,-22,57,-8,-4
2014,NC,11,85342,144682,230024,1,r,370222,181363,188859,744956,664853,80103,536245,127696,408549,744956,100546,143545,157854,157833,296292,171590,89416,35286,-16,4,9,-5,-6,-16,11,-11,-16,-22,42,-8,-4
2014,NC,12,130096,42568,172664,0,d,426200,204479,221721,778251,281070,497181,486997,119774,367223,778251,176899,154967,126412,73967,292966,182551,80444,29971,-16,4,9,-5,-6,-16,11,-11,-16,-22,63,-8,-4
2014,NC,13,114718,153991,268709,1,r,326931,158564,168367,772469,564695,207774,518649,209737,308912,772469,117199,171014,155262,99829,289173,112281,91116,85776,-16,4,9,-5,-6,-16,11,-11,-16,-22,56,-8,-4
2014,NC,2,85479,122128,207607,1,r,349966,173775,176191,774723,554735,219988,507194,151814,355380,774723,137634,158585,139168,104162,283123,140362,85094,57667,-16,4,9,-5,-6,-16,11,-11,-16,-22,51,-8,-3
2014,NC,3,66182,139415,205597,1,r,384799,195095,189704,759653,559981,199672,483041,110609,372432,759653,155448,134692,133633,110189,286013,154298,91527,40188,-16,4,9,-5,-6,-16,11,-11,-16,-22,60,-8,-4
2014,NC,4,169946,57416,227362,1,d,386481,188166,198315,795798,452826,342972,510859,209424,301435,795798,176982,162954,128594,84421,308881,160951,83887,64043,-16,4,9,-5,-6,-16,11,-11,-16,-22,55,-8,-2
2014,NC,5,88973,139279,228252,1,r,398038,193029,205009,750233,611522,138711,506186,131505,374681,750233,115707,146871,153284,121854,291365,161177,87111,43077,-16,4,9,-5,-6,-16,11,-11,-16,-22,53,-8,-3
2014,NC,6,103758,147312,251070,0,r,373636,179440,194196,755280,582565,172715,526846,149323,377523,755280,110219,151936,164836,125799,297049,151631,87059,58359,-16,4,9,-5,-6,-16,11,-11,-16,-22,55,-8,-4
2014,NC,7,84054,134431,226504,0,d,411898,201164,210734,772311,578050,194261,532224,125913,406311,772311,112517,153916,160209,132834,297924,163425,82123,52376,-16,4,9,-5,-6,-16,11,-11,-16,-22,59,-8,-5
2014,NC,8,65854,121568,187422,1,r,402578,198286,204292,746671,498903,247768,498795,90827,407968,746671,117015,151533,143293,111591,273964,158507,78385,37072,-16,4,9,-5,-6,-16,11,-11,-16,-22,58,-8,-5
2014,NC,9,0,163080,173668,1,r,321168,154651,166517,805960,621879,184081,543206,267578,275628,805960,124591,186671,156101,96630,303975,101542,95855,106578,-16,4,9,-5,-6,-16,11,-11,-16,-22,47,-8,-4
2014,ND,1,0,138100,248670,1,r,349465,177843,171622,739482,654375,85107,478850,131316,347534,739482,152774,127828,138349,104679,305431,131498,99520,74413,-16,4,9,-5,-6,-16,11,-11,-16,-22,38,-8,-5
2014,NE,1,55838,123219,179057,1,r,295759,147272,148487,634290,567672,66618,404549,121517,283032,634290,116765,114912,117054,88161,249406,112220,86133,51053,-16,4,9,-5,-6,-16,11,-11,-16,-22,34,-8,-5
2014,NE,2,83872,78157,171509,0,r,319871,158612,161259,641045,525423,115622,413909,156151,257758,641045,126655,125502,114665,71659,243695,106610,76923,60162,-16,4,9,-5,-6,-16,11,-11,-16,-22,45,-8,-4
2014,NE,3,45524,139440,184964,1,r,296880,148147,148733,606168,567881,38287,406243,84101,322142,606168,89508,105527,121766,110857,247664,127678,82097,37889,-16,4,9,-5,-6,-16,11,-11,-16,-22,30,-8,-5
2014,NH,1,116769,125508,242736,0,d,223912,110033,113879,665612,621376,44236,467691,168577,299114,665612,107076,131097,151296,103178,262564,96341,81629,84594,-16,4,9,-5,-6,-16,11,-11,-16,-22,29,-8,-3
2014,NH,2,130700,106871,238184,0,d,251771,124790,126981,661201,618034,43167,463613,157453,306160,661201,95521,133282,151583,106269,257192,97152,86471,73569,-16,4,9,-5,-6,-16,11,-11,-16,-22,27,-8,-3
2014,NJ,1,93315,64073,162492,0,d,252172,121727,130445,732232,493899,238333,499578,151964,347614,732232,131893,144140,149384,106412,271572,108229,80687,82656,-16,4,9,-5,-6,-16,11,-11,-16,-22,48,-8,-4
2014,NJ,10,95734,14154,112123,0,d,251607,119262,132345,742855,215409,527446,487616,133364,354252,742855,145368,156051,140021,82245,263010,136285,71718,55007,-16,4,9,-5,-6,-16,11,-11,-16,-22,59,-8,-4
2014,NJ,11,65477,109455,174932,1,r,193941,93316,100625,739014,606493,132521,521185,272543,248642,739014,101233,156035,161584,126601,263467,60163,72714,130590,-16,4,9,-5,-6,-16,11,-11,-16,-22,23,-8,-3
2014,NJ,12,90430,54168,148366,0,d,295677,145492,150185,742832,434703,308129,514957,224121,290836,742832,124458,158187,152351,107343,266054,85624,74917,105513,-16,4,9,-5,-6,-16,11,-11,-16,-22,35,-8,-2
2014,NJ,2,66026,108875,177148,1,r,319241,157407,161834,733973,546140,187833,506756,118403,388353,733973,117442,143479,154421,122069,268122,117405,81778,68939,-16,4,9,-5,-6,-16,11,-11,-16,-22,45,-8,-4
2014,NJ,3,82537,100471,186103,0,r,211262,103771,107491,734551,590511,144040,518644,173915,344729,734551,111764,144022,156988,134369,274785,87033,88127,99625,-16,4,9,-5,-6,-16,11,-11,-16,-22,46,-8,-4
2014,NJ,4,54415,118826,174849,1,r,260085,125126,134959,748864,641020,107844,507750,196374,311376,748864,107449,138615,156395,132163,270829,90950,74108,105771,-16,4,9,-5,-6,-16,11,-11,-16,-22,39,-8,-3
2014,NJ,5,81808,104678,188921,1,r,197674,97034,100640,745147,577207,167940,514957,230324,284633,745147,100072,155283,168062,117829,264036,67421,74266,122349,-16,4,9,-5,-6,-16,11,-11,-16,-22,25,-8,-3
2014,NJ,6,72190,46891,120457,0,d,294137,144663,149474,748924,476633,272291,502007,193997,308010,748924,136973,157906,144466,93531,250583,80343,76305,93935,-16,4,9,-5,-6,-16,11,-11,-16,-22,27,-8,-3
2014,NJ,7,68232,104287,175997,1,r,245221,119513,125708,748182,598504,149678,509789,265741,244048,748182,93901,163230,169593,108930,264239,62453,61857,139929,-16,4,9,-5,-6,-16,11,-11,-16,-22,25,-8,-2
2014,NJ,8,61510,15141,79518,1,d,334411,169648,164763,762249,437554,324695,528369,162034,366335,762249,190714,168618,126391,77019,276592,129645,79640,67307,-16,4,9,-5,-6,-16,11,-11,-16,-22,30,-8,-3
2014,NJ,9,82498,36246,120459,0,d,229800,111456,118344,759352,435583,323769,516323,168488,347835,759352,139293,159882,143358,103614,261555,113084,68826,79645,-16,4,9,-5,-6,-16,11,-11,-16,-22,30,-8,-4
2014,NM,1,105474,74558,180032,1,d,325916,158963,166953,699493,507433,192060,473911,150894,323017,699493,132880,131486,137414,103680,270360,143493,73817,53050,-16,4,9,-5,-6,-16,11,-11,-16,-22,27,-8,-2
2014,NM,2,52499,95209,147777,1,r,344172,172387,171785,699424,575111,124313,444288,93590,350698,699424,120715,119803,127790,109869,248398,146827,68736,32835,-16,4,9,-5,-6,-16,11,-11,-16,-22,27,-8,-3
2014,NM,3,113249,70775,184076,0,d,330813,164422,166391,686655,442915,243740,455623,118450,337173,686655,112808,126284,136701,104537,242158,126118,72719,43321,-16,4,9,-5,-6,-16,11,-11,-16,-22,27,-8,-2
2014,NV,1,45643,30413,80299,1,d,345320,178329,166991,693623,380587,313036,463285,70239,393046,693623,143394,135343,130316,88117,245248,154845,66052,24351,-16,4,9,-5,-6,-16,11,-11,-16,-22,32,-8,-4
2014,NV,2,52016,122402,186210,1,r,322612,163535,159077,697426,580111,117315,475834,120563,355271,697426,122787,130343,143221,108256,262993,123408,85464,54121,-16,4,9,-5,-6,-16,11,-11,-16,-22,25,-8,-4
2014,NV,3,52644,88528,145719,1,r,210659,104193,106466,734973,499767,235206,514193,163402,350791,734973,134897,162419,137541,105942,274521,103295,99731,71495,-16,4,9,-5,-6,-16,11,-11,-16,-22,25,-8,-4
2014,NV,4,59844,63466,130781,1,d,288127,142024,146103,713077,470799,242278,466286,89259,377027,713077,123751,147585,126635,98199,238757,113343,82653,42761,-16,4,9,-5,-6,-16,11,-11,-16,-22,38,-8,-4
2014,NY,1,68387,77062,176719,1,d,271599,133618,137981,725932,629036,96896,500340,174727,325613,725932,103931,147546,156169,119218,249690,72054,72159,105477,-16,4,9,-5,-6,-16,11,-11,-16,-22,34,-8,-2
2014,NY,10,73945,0,113226,1,d,296985,145670,151315,736997,508244,228753,528636,317729,210907,736997,175483,152438,124982,101748,310947,105403,71903,133641,-16,4,9,-5,-6,-16,11,-11,-16,-22,17,-8,-1
2014,NY,11,41429,48291,110999,1,r,206630,99594,107036,726893,523059,203834,503241,168172,335069,726893,132331,146331,148348,108150,258510,107435,72973,78102,-16,4,9,-5,-6,-16,11,-11,-16,-22,28,-8,-3
2014,NY,12,78440,19564,117420,1,d,321325,152656,168669,729253,534814,194439,576798,413854,162944,729253,238488,151610,116912,103067,367878,104530,86620,176728,-16,4,9,-5,-6,-16,11,-11,-16,-22,23,-8,-2
2014,NY,13,63437,0,91834,1,d,329244,155602,173642,782199,189494,592705,527663,152078,375585,782199,195396,161145,137143,85515,291316,176243,74130,40943,-16,4,9,-5,-6,-16,11,-11,-16,-22,43,-8,-3
2014,NY,14,45370,0,67372,1,d,337279,170812,166467,752344,363006,389338,526629,136410,390219,752344,186662,161516,130142,90710,249345,120050,81263,48032,-16,4,9,-5,-6,-16,11,-11,-16,-22,28,-8,-4
2014,NY,15,53128,0,61268,1,d,321680,148992,172688,750915,93823,657092,443956,56137,387819,750915,160067,141138,117747,69554,247735,189745,43509,14481,-16,4,9,-5,-6,-16,11,-11,-16,-22,44,-8,-5
2014,NY,16,90088,0,138655,1,d,246940,117186,129754,732521,364206,368315,496824,191910,304914,732521,118435,148748,142423,114006,263056,106875,72309,83872,-16,4,9,-5,-6,-16,11,-11,-16,-22,50,-8,-2
2014,NY,17,89295,63549,181674,1,d,280069,136032,144037,739263,514553,224710,489244,226253,262991,739263,111373,144894,148451,112076,242676,70782,59372,112522,-16,4,9,-5,-6,-16,11,-11,-16,-22,36,-8,-2
2014,NY,18,76235,66523,186715,1,d,237399,118403,118996,720115,550462,169653,473914,165877,308037,720115,105639,145106,149915,102127,244301,80519,71090,92692,-16,4,9,-5,-6,-16,11,-11,-16,-22,41,-8,-2
2014,NY,19,60533,102118,210351,1,r,247398,122939,124459,708116,635037,73079,500570,136177,364393,708116,104878,132331,163570,127561,268269,119079,86053,63137,-16,4,9,-5,-6,-16,11,-11,-16,-22,43,-8,-2
2014,NY,2,41814,76659,146617,1,r,270655,132244,138411,724171,554025,170146,492282,142090,350192,724171,124521,148801,152609,98722,225524,63925,63756,97843,-16,4,9,-5,-6,-16,11,-11,-16,-22,39,-8,-3
2014,NY,20,103437,61820,211965,1,d,231343,112359,118984,727913,587787,140126,491805,181451,310354,727913,127604,137968,149178,111662,287521,118389,91513,77619,-16,4,9,-5,-6,-16,11,-11,-16,-22,45,-8,-2
2014,NY,21,53140,79615,181558,0,d,291317,149461,141856,713276,654195,59081,487418,114838,372580,713276,123679,134891,148479,114268,271972,131736,91233,49003,-16,4,9,-5,-6,-16,11,-11,-16,-22,46,-8,-2
2014,NY,22,0,113574,175372,1,r,242607,119601,123006,709851,640473,69378,480533,112129,368404,709851,112654,128810,149544,121362,275383,141728,87358,46297,-16,4,9,-5,-6,-16,11,-11,-16,-22,41,-8,-2
2014,NY,23,60233,94375,190554,1,r,317482,157949,159533,715663,651106,64557,477420,121152,356268,715663,114094,123850,148990,120189,281202,148148,88369,44685,-16,4,9,-5,-6,-16,11,-11,-16,-22,40,-8,-2
2014,NY,24,72631,93881,203417,0,d,254097,124305,129792,715188,604070,111118,482726,145041,337685,715188,117347,132830,149339,110781,280593,135587,88469,56537,-16,4,9,-5,-6,-16,11,-11,-16,-22,52,-8,-2
2014,NY,25,87264,75990,196516,1,d,245293,118262,127031,721227,546173,175054,488732,176119,312613,721227,131332,132466,144402,112161,287527,141211,85928,60388,-16,4,9,-5,-6,-16,11,-11,-16,-22,52,-8,-2
2014,NY,26,100648,38477,173911,1,d,320107,154615,165492,717332,515978,201354,493508,146128,347380,717332,142480,124804,142749,119748,306964,170290,87009,49665,-16,4,9,-5,-6,-16,11,-11,-16,-22,56,-8,-2
2014,NY,27,50939,109171,215147,0,d,251173,123902,127271,716757,665021,51736,504249,137190,367059,716757,101743,141225,166526,119338,279616,118017,92422,69177,-16,4,9,-5,-6,-16,11,-11,-16,-22,45,-8,-2
2014,NY,3,80393,63219,171163,1,d,200621,98049,102572,718780,539795,178985,504420,256994,247426,718780,92555,143790,160955,132656,247359,60612,61449,125298,-16,4,9,-5,-6,-16,11,-11,-16,-22,18,-8,-2
2014,NY,4,83772,67811,175305,0,d,238518,115300,123218,721920,475570,246350,494934,198589,296345,721920,116463,144949,147937,113509,231363,60694,62039,108630,-16,4,9,-5,-6,-16,11,-11,-16,-22,42,-8,-2
2014,NY,5,75712,0,94400,1,d,214460,101291,113169,760487,132469,628018,511127,120906,390221,760487,140749,153595,151589,100133,227580,95785,70973,60822,-16,4,9,-5,-6,-16,11,-11,-16,-22,53,-8,-3
2014,NY,6,49227,0,77306,1,d,250730,120417,130313,733419,329763,403656,545162,186988,358174,733419,137879,162090,156993,116114,269779,115250,81945,72584,-16,4,9,-5,-6,-16,11,-11,-16,-22,12,-8,-3
2014,NY,7,47142,5713,68522,0,d,301310,147485,153825,732079,351153,380926,494068,155853,338215,732079,190335,154712,119465,70783,254793,130544,61403,62846,-16,4,9,-5,-6,-16,11,-11,-16,-22,27,-8,-3
2014,NY,8,70469,0,95113,1,d,201143,92640,108503,758543,220944,537599,508063,149022,359041,758543,157643,149175,137836,102895,281396,154642,69880,56874,-16,4,9,-5,-6,-16,11,-11,-16,-22,60,-8,-3
2014,NY,9,70997,0,101606,1,d,225874,103598,122276,755073,260056,495017,515350,184168,331182,755073,165536,154600,134319,97627,280103,141301,79326,59476,-16,4,9,-5,-6,-16,11,-11,-16,-22,60,-8,-3
2014,OH,1,72604,124779,197383,1,r,333238,163271,169967,729726,520929,208797,478417,157654,320763,729726,125556,141241,143269,96760,285010,136886,83559,64565,-16,4,9,-5,-6,-16,11,-11,-16,-22,64,-8,-3
2014,OH,10,63249,130752,200606,1,r,289720,140416,149304,720794,555234,165560,487929,136613,351316,720794,124238,130763,145339,118210,295834,158137,83579,54118,-16,4,9,-5,-6,-16,11,-11,-16,-22,63,-8,-3
2014,OH,11,137105,35461,172566,1,d,270192,126998,143194,699736,276982,422754,467579,122382,345197,699736,125996,124975,142934,105744,298796,192151,68220,38425,-16,4,9,-5,-6,-16,11,-11,-16,-22,72,-8,-2
2014,OH,12,61360,150573,221081,1,r,262888,131032,131856,755978,670849,85129,507779,205255,302524,755978,121021,159520,151481,101287,285099,107082,86803,91214,-16,4,9,-5,-6,-16,11,-11,-16,-22,40,-8,-3
2014,OH,13,120230,55233,175549,1,d,293657,142570,151087,707940,587070,120870,488865,105120,383745,707940,121990,127357,147034,125239,297444,174556,87275,35613,-16,4,9,-5,-6,-16,11,-11,-16,-22,61,-8,-4
2014,OH,14,70856,135736,214580,1,r,205414,100148,105266,722474,660841,61633,505833,168186,337647,722474,98037,140522,161661,130710,287411,117507,93132,76772,-16,4,9,-5,-6,-16,11,-11,-16,-22,45,-8,-3
2014,OH,15,66125,128496,194621,1,r,290787,147255,143532,740854,671472,69382,504874,154800,350074,740854,129278,151990,148007,105960,280269,123131,91897,65241,-16,4,9,-5,-6,-16,11,-11,-16,-22,45,-8,-3
2014,OH,16,75199,132176,207375,1,r,201323,97904,103419,724483,678063,46420,510353,167108,343245,724483,107320,136963,161022,129402,286387,114322,97667,74398,-16,4,9,-5,-6,-16,11,-11,-16,-22,35,-8,-3
2014,OH,2,68453,132658,201111,0,r,314603,153337,161266,724587,632706,91881,501089,151449,349640,724587,128098,141526,151128,111135,291964,141044,87404,63516,-16,4,9,-5,-6,-16,11,-11,-16,-22,60,-8,-3
2014,OH,3,91769,51475,143261,1,d,351993,169372,182621,755499,431238,324261,480314,131328,348986,755499,173693,145116,124384,72237,296151,169677,85349,41125,-16,4,9,-5,-6,-16,11,-11,-16,-22,64,-8,-4
2014,OH,4,60165,125907,186072,1,r,226714,113626,113088,709882,636815,73067,486519,80164,406355,709882,108775,136937,150888,116092,277572,145808,91074,40690,-16,4,9,-5,-6,-16,11,-11,-16,-22,54,-8,-4
2014,OH,5,58507,134449,202300,1,r,196794,96238,100556,730503,674732,55771,488365,127709,360656,730503,112556,135843,152833,115792,288070,135365,95625,57080,-16,4,9,-5,-6,-16,11,-11,-16,-22,42,-8,-3
2014,OH,6,73561,111026,190652,1,r,223592,111262,112330,713457,680310,33147,502548,80191,422357,713457,103013,135398,158392,128957,278327,155946,82752,39629,-16,4,9,-5,-6,-16,11,-11,-16,-22,54,-8,-3
2014,OH,7,0,143959,143959,1,r,282491,138896,143595,725548,669900,55648,491031,90725,400306,725548,108650,133722,151497,125165,277654,142041,91251,44362,-16,4,9,-5,-6,-16,11,-11,-16,-22,56,-8,-4
2014,OH,8,51534,126539,188330,1,r,300496,147557,152939,722889,641380,81509,477605,110003,367602,722889,113500,136662,145917,111346,273993,131366,87752,54875,-16,4,9,-5,-6,-16,11,-11,-16,-22,52,-8,-3
2014,OH,9,108870,51704,160715,1,d,255101,123679,131422,709813,533743,176070,478360,103531,374829,709813,126275,138652,140240,102832,293191,176361,79108,37722,-16,4,9,-5,-6,-16,11,-11,-16,-22,55,-8,-3
2014,OK,1,0,1,1,1,r,409708,200086,209622,781067,561789,219278,511782,150893,360889,781067,143635,150273,145854,105061,305903,148554,96237,61112,-16,4,9,-5,-6,-16,11,-11,-16,-22,46,-8,-4
2014,OK,2,38964,110925,158407,1,r,371987,184876,187111,749768,501360,248408,502822,80818,422004,749768,114109,136723,146530,133127,280477,170192,77837,32448,-16,4,9,-5,-6,-16,11,-11,-16,-22,47,-8,-4
2014,OK,3,36270,133335,169605,1,r,397701,200205,197496,776896,619767,157129,501631,110503,391128,776896,137587,140579,144745,116023,285371,145078,91905,48388,-16,4,9,-5,-6,-16,11,-11,-16,-22,39,-8,-4
2014,OK,4,40998,117721,166268,1,r,302559,150926,151633,773994,589200,184794,495792,116984,378808,773994,143900,143181,139325,104745,284755,135738,95219,53798,-16,4,9,-5,-6,-16,11,-11,-16,-22,45,-8,-4
2014,OK,5,57790,95632,159133,0,r,432822,211594,221228,796326,555365,240961,517858,152170,365688,796326,158688,150494,142994,102612,303253,158419,85604,59230,-16,4,9,-5,-6,-16,11,-11,-16,-22,46,-8,-3
2014,OR,1,160038,96245,279253,1,d,365015,179760,185255,805943,653786,152157,551597,209993,341604,805943,145704,173287,156371,105267,305696,121626,99761,84309,-16,4,9,-5,-6,-16,11,-11,-16,-22,20,-8,-3
2014,OR,2,73785,202374,287425,1,r,418564,207804,210760,784114,700351,83763,547291,128066,419225,784114,122254,141759,162075,149828,302941,168356,89887,44698,-16,4,9,-5,-6,-16,11,-11,-16,-22,26,-8,-3
2014,OR,3,211748,57424,292757,1,d,357784,178129,179655,806382,630754,175628,574420,214763,359657,806382,174727,176634,154402,101549,317520,149094,95906,72520,-16,4,9,-5,-6,-16,11,-11,-16,-22,30,-8,-4
2014,OR,4,181624,116534,310179,1,d,384491,190234,194257,775615,696204,79411,536426,139224,397202,775615,130707,132407,163907,148967,313058,174128,94274,44656,-16,4,9,-5,-6,-16,11,-11,-16,-22,24,-8,-3
2014,OR,5,150944,110332,281088,1,d,356198,175326,180872,798185,677155,121030,537223,154200,383023,798185,128359,151690,159455,128615,296296,136916,95117,64263,-16,4,9,-5,-6,-16,11,-11,-16,-22,24,-8,-3
2014,PA,1,131248,27193,158441,1,d,300078,145907,154171,716072,350648,365424,482755,126064,356691,716072,167448,138269,126069,82621,266461,154305,70139,42017,-16,4,9,-5,-6,-16,11,-11,-16,-22,55,-8,-3
2014,PA,10,44737,112851,180322,1,r,209499,105410,104089,696416,645270,51146,489243,97764,391479,696416,101482,129393,154384,128612,265081,136943,84996,43142,-16,4,9,-5,-6,-16,11,-11,-16,-22,48,-8,-3
2014,PA,11,62228,122464,184692,1,r,250360,124256,126104,700342,627688,72654,495384,118876,376508,700342,106392,135031,151705,125779,279363,134021,92172,53170,-16,4,9,-5,-6,-16,11,-11,-16,-22,46,-8,-3
2014,PA,12,87928,127993,215921,1,r,239097,117169,121928,704560,653438,51122,512787,159288,353499,704560,101079,131933,160710,141111,287682,126045,93508,68129,-16,4,9,-5,-6,-16,11,-11,-16,-22,49,-8,-3
2014,PA,13,123601,60549,184150,0,d,252442,123065,129377,725185,474577,250608,503675,167235,336440,725185,135309,143155,143284,110466,269264,120636,80303,68325,-16,4,9,-5,-6,-16,11,-11,-16,-22,43,-8,-3
2014,PA,14,148351,0,148351,1,d,335582,160663,174919,701362,501029,200333,495940,155087,340853,701362,151621,120394,145086,114220,311663,177516,88405,45742,-16,4,9,-5,-6,-16,11,-11,-16,-22,65,-8,-3
2014,PA,15,0,128285,128285,1,r,260401,126593,133808,722560,603405,119155,494965,136339,358626,722560,116287,137790,150691,118883,273061,111643,95212,66206,-16,4,9,-5,-6,-16,11,-11,-16,-22,36,-8,-3
2014,PA,16,74513,101722,176235,1,r,321206,157670,163536,722837,582383,140454,476490,119016,357474,722837,122188,135959,137576,109404,262000,118240,86386,57374,-16,4,9,-5,-6,-16,11,-11,-16,-22,41,-8,-4
2014,PA,17,93680,71371,165051,0,d,225517,110878,114639,707062,627687,79375,494898,105476,389422,707062,107458,137030,147328,128427,268401,137607,84597,46197,-16,4,9,-5,-6,-16,11,-11,-16,-22,43,-8,-4
2014,PA,18,0,166076,166076,1,r,277573,135720,141853,712014,667643,44371,518238,179682,338556,712014,108856,137730,160052,134872,293422,120403,93276,79743,-16,4,9,-5,-6,-16,11,-11,-16,-22,41,-8,-3
2014,PA,2,181141,25397,206538,1,d,303378,136839,166539,716892,227955,488937,461101,153497,307604,716892,163533,118600,124919,95283,269128,161674,60564,46890,-16,4,9,-5,-6,-16,11,-11,-16,-22,68,-8,-1
2014,PA,3,73931,113859,187790,1,r,260465,128141,132324,702323,643403,58920,489690,120440,369250,702323,104992,131903,153606,125010,283310,147299,85515,50496,-16,4,9,-5,-6,-16,11,-11,-16,-22,56,-8,-4
2014,PA,4,50250,147090,197340,1,r,295576,145703,149873,719504,613141,106363,496788,128438,368350,719504,117933,142111,151171,115119,280428,121758,94634,64036,-16,4,9,-5,-6,-16,11,-11,-16,-22,47,-8,-3
2014,PA,5,65839,115018,180857,1,r,395133,201034,194099,700531,655480,45051,475238,109657,365581,700531,113079,125653,146105,121399,269986,143967,85348,40671,-16,4,9,-5,-6,-16,11,-11,-16,-22,43,-8,-3
2014,PA,6,92901,119643,212544,0,r,265008,129962,135046,716612,622923,93689,489909,208314,281595,716612,109215,144634,150702,111627,267004,85198,84332,97474,-16,4,9,-5,-6,-16,11,-11,-16,-22,36,-8,-3
2014,PA,7,89256,145869,235125,1,r,240738,116623,124115,714577,625551,89026,491737,206362,285375,714577,105641,136135,154560,120105,260127,84415,76036,99676,-16,4,9,-5,-6,-16,11,-11,-16,-22,39,-8,-2
2014,PA,8,84767,137731,222498,1,r,214161,105157,109004,713387,629322,84065,502927,190552,312375,713387,102945,143153,162594,118481,263799,81552,81848,100399,-16,4,9,-5,-6,-16,11,-11,-16,-22,31,-8,-3
2014,PA,9,63223,110094,173317,1,r,325647,160623,165024,694973,657304,37669,487100,85638,401462,694973,101786,129603,149788,132680,275792,152310,86533,36949,-16,4,9,-5,-6,-16,11,-11,-16,-22,55,-8,-3
2014,RI,1,87060,58877,146353,1,d,215607,105226,110381,532145,416401,115744,361936,111430,250506,532145,95600,102638,105586,80585,205292,98292,56687,50313,-16,4,9,-5,-6,-16,11,-11,-16,-22,40,-8,-2
2014,RI,2,105716,63844,169904,1,d,186609,89888,96721,523028,441835,81193,363935,109464,254471,523028,87845,100075,112290,86595,204362,88749,62183,53430,-16,4,9,-5,-6,-16,11,-11,-16,-22,35,-8,-3
2014,SC,1,0,119392,127815,0,r,324888,157941,166947,728626,550128,178498,506979,190231,316748,728626,133125,142790,138714,119021,279589,114523,93113,71953,-16,4,9,-5,-6,-16,11,-11,-16,-22,60,-8,-3
2014,SC,2,68719,121649,194808,1,r,318621,154990,163631,686952,485612,201340,459797,153143,306654,686952,118999,136715,137693,97024,260687,120041,83260,57386,-16,4,9,-5,-6,-16,11,-11,-16,-22,64,-8,-3
2014,SC,3,47181,116741,164009,1,r,363765,178577,185188,666489,513017,153472,450959,92020,358939,666489,102496,125052,133886,115243,254391,151463,71189,31739,-16,4,9,-5,-6,-16,11,-11,-16,-22,67,-8,-3
2014,SC,4,0,126452,149049,1,r,315314,152804,162510,703720,526573,177147,468104,137601,330503,703720,124065,137483,135606,103101,264315,140443,78841,45031,-16,4,9,-5,-6,-16,11,-11,-16,-22,57,-8,-3
2014,SC,5,66802,103078,175145,1,r,312679,152796,159883,684083,464559,219524,462058,101327,360731,684083,104768,140960,137860,105685,255114,141366,72377,41371,-16,4,9,-5,-6,-16,11,-11,-16,-22,70,-8,-4
2014,SC,6,125747,44311,173432,1,d,375877,183665,192212,673637,258089,415548,433157,83860,349297,673637,134165,116061,125385,95020,242578,163780,56215,22583,-16,4,9,-5,-6,-16,11,-11,-16,-22,72,-8,-3
2014,SC,7,68576,102833,171524,1,r,348368,167524,180844,688975,456167,232808,479875,98791,381084,688975,105943,127452,145147,126489,270240,161094,76024,33122,-16,4,9,-5,-6,-16,11,-11,-16,-22,70,-8,-4
2014,SD,1,92485,183834,276319,1,r,347475,174061,173414,853175,724768,128407,555488,154216,401272,853175,148301,150162,164369,129354,334475,163647,111724,59104,-16,4,9,-5,-6,-16,11,-11,-16,-22,36,-8,-5
2014,TN,1,0,115533,139470,1,r,359120,175596,183524,713317,669519,43798,507769,101067,406702,713317,104302,139611,152142,134354,292994,181098,79911,31985,-16,4,9,-5,-6,-16,11,-11,-16,-22,44,-8,-3
2014,TN,2,37612,120883,166751,0,r,342315,166281,176034,726315,647641,78674,494464,145167,349297,726315,124682,140300,143620,120832,284921,153320,81616,49985,-16,4,9,-5,-6,-16,11,-11,-16,-22,52,-8,-3
2014,TN,3,53983,97344,156097,1,r,303119,147969,155150,716365,609815,106550,502247,116022,386225,716365,111809,141497,152496,121801,277570,154891,78723,43956,-16,4,9,-5,-6,-16,11,-11,-16,-22,60,-8,-3
2014,TN,4,51357,84815,145418,0,r,420766,205687,215079,747195,634819,112376,491560,104228,387332,747195,127260,150495,140129,106790,277263,150234,84700,42329,-16,4,9,-5,-6,-16,11,-11,-16,-22,52,-8,-4
2014,TN,5,96148,55078,154276,1,d,395936,190577,205359,751222,496065,255157,510362,178064,332298,751222,171455,151162,136054,85432,297372,153994,87065,56313,-16,4,9,-5,-6,-16,11,-11,-16,-22,58,-8,-4
2014,TN,6,37232,115231,162097,1,r,344252,169518,174734,733467,668026,65441,504797,102735,402062,733467,109838,144603,148786,126505,280870,150267,86548,44055,-16,4,9,-5,-6,-16,11,-11,-16,-22,49,-8,-4
2014,TN,7,42280,110534,157907,1,r,296785,147635,149150,743173,628772,114401,488947,131407,357540,743173,122075,152066,143107,103331,268304,135133,77795,55376,-16,4,9,-5,-6,-16,11,-11,-16,-22,55,-8,-3
2014,TN,8,42433,122255,172595,1,r,275128,133885,141243,710910,540489,170421,476017,139946,336071,710910,102768,141011,145078,112416,265181,125744,78060,61377,-16,4,9,-5,-6,-16,11,-11,-16,-22,65,-8,-4
2014,TN,9,87376,27173,116550,1,d,392120,185834,206286,707388,189258,518130,448910,99671,349239,707388,150802,132562,129044,75352,265190,170830,64465,29895,-16,4,9,-5,-6,-16,11,-11,-16,-22,72,-8,-3
2014,TX,1,33476,115084,148560,1,r,390190,192097,198093,712779,547425,165354,458357,93424,364933,712779,115757,126602,130714,114330,255970,142010,73906,40054,-16,4,9,-5,-6,-16,11,-11,-16,-22,52,-8,-4
2014,TX,10,60243,109726,176460,1,r,343294,171043,172251,771009,594753,176256,503672,190466,313206,771009,130269,166095,141414,88856,271381,101240,83137,87004,-16,4,9,-5,-6,-16,11,-11,-16,-22,35,-8,-4
2014,TX,11,0,107939,119574,1,r,354584,179131,175453,741069,641043,100026,482294,98273,384021,741069,139453,129079,135328,113614,267234,130151,76474,60609,-16,4,9,-5,-6,-16,11,-11,-16,-22,30,-8,-5
2014,TX,12,41757,113186,158730,1,r,330766,161771,168995,750952,595369,155583,490651,145919,344732,750952,146566,148029,135337,93197,271290,109294,92865,69131,-16,4,9,-5,-6,-16,11,-11,-16,-22,36,-8,-4
2014,TX,13,16822,110842,131451,1,r,397821,204427,193394,707803,602037,105766,459487,90769,368718,707803,129664,130277,132320,100604,256294,131012,77963,47319,-16,4,9,-5,-6,-16,11,-11,-16,-22,33,-8,-5
2014,TX,14,52545,90116,145698,0,r,336685,169846,166839,724881,524080,200801,480163,106754,373409,724881,127444,143106,143969,94635,266576,128732,73671,64173,-16,4,9,-5,-6,-16,11,-11,-16,-22,46,-8,-4
2014,TX,15,48708,39016,90184,1,d,374155,184748,189407,764850,677387,87463,437484,86082,351402,764850,137027,145004,107141,81411,217726,127308,59005,31413,-16,4,9,-5,-6,-16,11,-11,-16,-22,27,-8,-5
2014,TX,16,49338,21324,73105,1,d,299804,147907,151897,735246,606900,128346,444300,102442,341858,735246,145657,136931,117152,83823,229932,135285,61558,33089,-16,4,9,-5,-6,-16,11,-11,-16,-22,28,-8,-4
2014,TX,17,43049,85807,132865,1,r,389593,193077,196516,740151,551347,188804,448524,127947,320577,740151,157344,136627,120160,83714,273445,139519,82948,50978,-16,4,9,-5,-6,-16,11,-11,-16,-22,40,-8,-3
2014,TX,18,76097,26249,106010,1,d,385982,194278,191704,750812,336708,414104,465246,100353,364893,750812,163996,151734,116218,65930,260178,146582,68142,45454,-16,4,9,-5,-6,-16,11,-11,-16,-22,49,-8,-4
2014,TX,19,21458,90160,116818,1,r,372549,189421,183128,719594,581063,138531,440849,94270,346579,719594,145615,122285,119637,95153,257049,140466,74590,41993,-16,4,9,-5,-6,-16,11,-11,-16,-22,33,-8,-4
2014,TX,2,44462,101936,150026,1,r,346987,174028,172959,737492,520828,216664,496001,195870,300131,737492,159829,152561,142101,73480,269587,91080,83773,94734,-16,4,9,-5,-6,-16,11,-11,-16,-22,33,-8,-4
2014,TX,20,66554,0,87964,1,d,362542,178168,184374,762801,613448,149353,470051,107450,362601,762801,170597,143787,118359,78464,248715,131226,75668,41821,-16,4,9,-5,-6,-16,11,-11,-16,-22,28,-8,-4
2014,TX,21,0,135660,188996,1,r,353877,177326,176551,766190,673943,92247,528809,236444,292365,766190,151463,147460,147637,116742,306367,125824,92119,88424,-16,4,9,-5,-6,-16,11,-11,-16,-22,28,-8,-3
2014,TX,22,47844,100861,151566,1,r,262030,129653,132377,814594,508767,305827,518308,230892,287416,814594,130107,187680,147198,79169,263321,65699,79827,117795,-16,4,9,-5,-6,-16,11,-11,-16,-22,30,-8,-3
2014,TX,23,55037,57459,115429,0,d,322467,161462,161005,743201,634400,108801,450916,96016,354900,743201,129365,141625,120392,91511,226174,109510,65979,50685,-16,4,9,-5,-6,-16,11,-11,-16,-22,28,-8,-3
2014,TX,24,46548,93712,144073,1,r,363776,178470,185306,759022,510456,248566,520077,226583,293494,759022,163945,168557,141253,76576,304192,119259,88934,95999,-16,4,9,-5,-6,-16,11,-11,-16,-22,31,-8,-4
2014,TX,25,64463,107120,177883,1,r,317835,155339,162496,748022,621393,126629,490469,173030,317439,748022,139099,148534,139750,93544,266438,110473,80308,75657,-16,4,9,-5,-6,-16,11,-11,-16,-22,37,-8,-3
2014,TX,26,0,116944,141470,1,r,337779,166719,171060,783257,633699,149558,497011,203186,293825,783257,137043,180876,136766,71165,266038,81445,82847,101746,-16,4,9,-5,-6,-16,11,-11,-16,-22,33,-8,-4
2014,TX,27,44152,83342,131047,1,r,350879,173719,177160,726394,630289,96105,475848,91168,384680,726394,130826,133522,137401,104188,259534,127746,78213,53575,-16,4,9,-5,-6,-16,11,-11,-16,-22,30,-8,-4
2014,TX,28,62508,0,76136,1,d,355546,172364,183182,725977,641325,84652,422770,70275,352495,725977,123675,137239,113463,77861,208891,113827,61047,34017,-16,4,9,-5,-6,-16,11,-11,-16,-22,28,-8,-4
2014,TX,29,41321,0,46143,1,d,391588,196894,194694,749098,550169,198929,437608,40005,397603,749098,159656,149406,110324,57825,224503,136976,64056,23471,-16,4,9,-5,-6,-16,11,-11,-16,-22,32,-8,-4
2014,TX,3,0,113404,138280,1,r,292364,143392,148972,792608,562418,230190,516077,269583,246494,792608,131486,190698,144062,76813,283000,76910,80631,125459,-16,4,9,-5,-6,-16,11,-11,-16,-22,29,-8,-3
2014,TX,30,93041,0,105793,1,d,382879,183882,198997,744247,356920,387327,458572,84107,374465,744247,139774,153299,128063,68243,249315,146217,67832,35266,-16,4,9,-5,-6,-16,11,-11,-16,-22,52,-8,-4
2014,TX,31,45715,91607,143028,1,r,312212,155397,156815,776518,591783,184735,495142,168213,326929,776518,147279,167670,127534,85284,267991,103524,91538,72929,-16,4,9,-5,-6,-16,11,-11,-16,-22,38,-8,-4
2014,TX,32,55325,96495,156096,1,r,347552,171572,175980,747437,524310,223127,498974,212923,286051,747437,150281,159982,138474,88132,286216,109453,85375,91388,-16,4,9,-5,-6,-16,11,-11,-16,-22,36,-8,-3
2014,TX,33,43769,0,50592,0,d,410813,207102,203711,742701,497928,244773,429103,38353,390750,742701,155071,145464,107086,56098,223616,147966,59754,15896,-16,4,9,-5,-6,-16,11,-11,-16,-22,36,-8,-5
2014,TX,34,47503,30811,79877,1,d,349546,173599,175947,717582,664202,53380,425279,65830,359449,717582,119332,130471,111830,94905,211742,131689,50564,29489,-16,4,9,-5,-6,-16,11,-11,-16,-22,26,-8,-5
2014,TX,35,60124,32040,96225,1,d,435753,217153,218600,767436,593871,173565,470984,86283,384701,767436,173459,153440,120071,67067,254107,149130,74529,30448,-16,4,9,-5,-6,-16,11,-11,-16,-22,33,-8,-5
2014,TX,36,29543,101663,133842,0,r,355832,178661,177171,731297,603518,127779,478205,89666,388539,731297,121247,143033,142437,98133,257309,118042,79369,59898,-16,4,9,-5,-6,-16,11,-11,-16,-22,38,-8,-4
2014,TX,4,0,115085,115085,0,r,359343,177695,181648,719372,581866,137506,479528,94257,385271,719372,100782,140874,140848,115687,255142,129918,78058,47166,-16,4,9,-5,-6,-16,11,-11,-16,-22,47,-8,-4
2014,TX,5,0,88998,104262,1,r,394521,200151,194370,734553,548690,185863,473561,94639,378922,734553,127400,145351,133392,94271,249636,133196,73956,42484,-16,4,9,-5,-6,-16,11,-11,-16,-22,43,-8,-4
2014,TX,6,55027,92334,150996,1,r,300298,145353,154945,737480,503636,233844,462218,133285,328933,737480,130556,153804,136087,76511,255443,103137,85922,66384,-16,4,9,-5,-6,-16,11,-11,-16,-22,46,-8,-4
2014,TX,7,49478,90606,143219,1,r,357798,175323,182475,770950,532116,238834,502706,237522,265184,770950,160450,167687,137085,74322,293681,106687,78254,108740,-16,4,9,-5,-6,-16,11,-11,-16,-22,33,-8,-3
2014,TX,8,0,125066,140013,1,r,366762,184942,181820,767431,638843,128588,497733,148656,349077,767431,127746,160021,145939,97110,257776,105072,77620,75084,-16,4,9,-5,-6,-16,11,-11,-16,-22,36,-8,-4
2014,TX,9,78109,0,86003,1,d,380343,186381,193962,772152,268930,503222,480911,118094,362817,772152,177470,152941,128435,67645,261388,148562,73834,38992,-16,4,9,-5,-6,-16,11,-11,-16,-22,45,-8,-3
2014,UT,1,36422,84231,130034,1,r,298434,150927,147507,727828,655306,72522,421714,122406,299308,727828,141216,133205,110840,72667,232907,88829,88859,55219,-16,4,9,-5,-6,-16,11,-11,-16,-22,27,-8,-4
2014,UT,2,47585,88915,146188,1,r,363139,184753,178386,729552,604994,124558,440026,128937,311089,729552,152547,131522,109560,85165,236700,108368,83449,44883,-16,4,9,-5,-6,-16,11,-11,-16,-22,25,-8,-3
2014,UT,3,32059,102952,142580,1,r,289747,145034,144713,721048,653941,67107,394140,153118,241022,721048,150082,124896,104856,68462,213752,78201,72805,62746,-16,4,9,-5,-6,-16,11,-11,-16,-22,24,-8,-4
2014,UT,4,67425,74936,147168,0,d,301800,149759,152041,764474,653777,110697,448854,125742,323112,764474,153905,151783,106727,68685,235011,86339,92490,56182,-16,4,9,-5,-6,-16,11,-11,-16,-22,26,-8,-5
2014,VA,1,72059,131861,209621,1,r,271490,133896,137594,770044,559315,210729,506299,184575,321724,770044,124648,158699,150436,105884,268803,83267,84896,100640,-16,4,9,-5,-6,-16,11,-11,-16,-22,51,-8,-2
2014,VA,10,89957,125914,222910,0,r,255498,127241,128257,802127,587601,214526,524325,289323,235002,802127,119857,184788,156981,87999,263798,52452,58586,152760,-16,4,9,-5,-6,-16,11,-11,-16,-22,26,-8,-2
2014,VA,11,106780,75796,187805,1,d,293387,145028,148359,782204,476589,305615,523480,278905,244575,782204,150293,176418,147834,80847,265346,51759,80059,133528,-16,4,9,-5,-6,-16,11,-11,-16,-22,30,-8,-1
2014,VA,2,71178,101558,173060,1,r,233925,116794,117131,732346,491575,240771,489863,158718,331145,732346,158196,140271,135066,93506,274587,109214,96092,69281,-16,4,9,-5,-6,-16,11,-11,-16,-22,54,-8,-3
2014,VA,3,139197,0,147402,1,d,355508,171152,184356,753380,263378,490002,483607,109118,374489,753380,180558,132166,132719,89370,286632,167302,81311,38019,-16,4,9,-5,-6,-16,11,-11,-16,-22,71,-8,-3
2014,VA,4,75270,120684,200638,1,r,244100,121444,122656,746976,457312,289664,500946,127278,373668,746976,123787,154255,151728,97959,265513,107210,90364,67939,-16,4,9,-5,-6,-16,11,-11,-16,-22,66,-8,-3
2014,VA,5,73482,124735,204945,1,r,354744,172363,182381,733330,546017,187313,512237,132542,379695,733330,110510,135754,157430,136227,289733,148783,87099,53851,-16,4,9,-5,-6,-16,11,-11,-16,-22,65,-8,-2
2014,VA,6,0,133898,179708,1,r,362401,176190,186211,746357,624845,121512,500226,135586,364640,746357,119960,133296,149173,127885,290076,145731,93893,50452,-16,4,9,-5,-6,-16,11,-11,-16,-22,55,-8,-3
2014,VA,7,89914,148026,243351,0,r,284042,136770,147272,769995,580958,189037,530331,211467,318864,769995,119599,160526,158332,113948,286332,89454,97351,99527,-16,4,9,-5,-6,-16,11,-11,-16,-22,51,-8,-3
2014,VA,8,128102,63810,203076,0,d,350523,172293,178230,774065,500276,273789,556318,340765,215553,774065,194642,177232,136334,80302,308510,70451,85359,152700,-16,4,9,-5,-6,-16,11,-11,-16,-22,34,-8,-1
2014,VA,9,0,117465,162815,1,r,339984,169344,170640,715465,651815,63650,495663,98062,397601,715465,112292,132786,148567,132919,284490,170182,78577,35731,-16,4,9,-5,-6,-16,11,-11,-16,-22,57,-8,-3
2014,VT,1,123349,59432,191504,1,d,241271,118801,122470,626562,591853,34709,438279,152901,285378,626562,99562,117290,141437,106655,257229,118907,84930,53392,-16,4,9,-5,-6,-16,11,-11,-16,-22,30,-8,-3
2014,WA,1,124151,101428,225579,0,d,302197,150148,152049,713399,581171,132228,485262,200384,284878,713399,124994,152238,145118,87321,259859,74737,78347,106775,-16,4,9,-5,-6,-16,11,-11,-16,-22,16,-8,-3
2014,WA,10,99279,82213,181492,1,d,248793,123247,125546,714449,528580,185869,471394,124457,346937,714449,147211,136077,132208,95650,261632,108548,94609,58475,-16,4,9,-5,-6,-16,11,-11,-16,-22,33,-8,-4
2014,WA,2,122173,79518,201691,1,d,273435,136372,137063,708323,555014,153309,482953,141940,341013,708323,133905,138261,141191,106599,275308,115681,91613,68014,-16,4,9,-5,-6,-16,11,-11,-16,-22,23,-8,-4
2014,WA,3,78018,124796,202814,1,r,265794,132482,133312,697884,602833,95051,473616,108552,365064,697884,107511,137760,141229,111563,264592,120247,88855,55490,-16,4,9,-5,-6,-16,11,-11,-16,-22,26,-8,-4
2014,WA,4,0,153079,153079,0,r,373944,188794,185150,704219,550204,154015,430336,82069,348267,704219,122609,127847,122035,90733,235617,116038,78304,41275,-16,4,9,-5,-6,-16,11,-11,-16,-22,26,-8,-4
2014,WA,5,87772,135470,223242,1,r,292523,145306,147217,690518,609439,81079,455887,126181,329706,690518,122826,121502,136181,106584,267126,137528,84308,45290,-16,4,9,-5,-6,-16,11,-11,-16,-22,30,-8,-3
2014,WA,6,141265,83025,224290,1,d,246701,124762,121939,676910,556302,120608,480489,139421,341068,676910,114551,122390,149310,122055,265236,119792,85503,59941,-16,4,9,-5,-6,-16,11,-11,-16,-22,32,-8,-3
2014,WA,7,203954,47921,251875,1,d,324054,164317,159737,732733,559471,173262,541498,310371,231127,732733,187868,161120,137865,93936,328789,117526,89799,121464,-16,4,9,-5,-6,-16,11,-11,-16,-22,24,-8,-3
2014,WA,8,73003,125741,198744,1,r,282090,139343,142747,711629,571399,140230,468112,152275,315837,711629,112669,148644,146085,84687,254292,82458,83484,88350,-16,4,9,-5,-6,-16,11,-11,-16,-22,24,-8,-4
2014,WA,9,118132,48662,166794,1,d,275673,138002,137671,711466,370584,340882,494937,199126,295811,711466,152101,150249,131893,93388,267150,102747,78172,86231,-16,4,9,-5,-6,-16,11,-11,-16,-22,25,-8,-3
2014,WI,1,105552,182316,288170,1,r,274330,134439,139891,712072,627841,84231,487223,137137,350086,712072,111853,143957,152766,104861,272387,113701,92179,66507,-16,4,9,-5,-6,-16,11,-11,-16,-22,41,-8,-4
2014,WI,2,224920,103619,328847,1,d,347824,172848,174976,740988,639685,101303,493055,201900,291155,740988,147719,143985,144059,97881,302685,131988,97411,73286,-16,4,9,-5,-6,-16,11,-11,-16,-22,37,-8,-3
2014,WI,3,155368,119540,275161,1,d,303933,152991,150942,718518,674641,43877,470614,115411,355203,718518,121027,126961,143598,115652,282399,141432,92255,48712,-16,4,9,-5,-6,-16,11,-11,-16,-22,26,-8,-4
2014,WI,4,179045,68490,254892,1,d,330322,159799,170523,717657,379841,337816,450992,123406,327586,717657,153142,135008,122792,78044,281593,170391,74463,36739,-16,4,9,-5,-6,-16,11,-11,-16,-22,57,-8,-3
2014,WI,5,101190,231160,332826,0,r,277057,136249,140808,722537,666082,56455,501637,177277,324360,722537,113742,140952,154049,117422,291080,114529,96473,80078,-16,4,9,-5,-6,-16,11,-11,-16,-22,29,-8,-4
2014,WI,6,122212,169767,299033,0,r,273678,138082,135596,712031,662755,49276,495700,122675,373025,712031,113000,136481,155628,118610,287900,132765,99744,55391,-16,4,9,-5,-6,-16,11,-11,-16,-22,30,-8,-4
2014,WI,7,112949,169896,286603,1,r,209032,105053,103979,711006,664903,46103,503912,109559,394353,711006,100468,133577,161551,131630,298690,149143,101842,47705,-16,4,9,-5,-6,-16,11,-11,-16,-22,27,-8,-4
2014,WI,8,101345,188553,290048,1,r,357538,178103,179435,722755,650534,72221,495029,120729,374300,722755,114746,141159,153823,111620,290951,133875,101189,55887,-16,4,9,-5,-6,-16,11,-11,-16,-22,30,-8,-5
2014,WV,1,52109,92491,144737,1,r,302085,150198,151887,616232,583607,32625,427354,92494,334860,616232,104657,114182,128934,107899,242233,138477,70704,33052,-16,4,9,-5,-6,-16,11,-11,-16,-22,49,-8,-3
2014,WV,2,67687,72619,154250,0,r,209146,103346,105800,628276,579286,48990,440215,90612,349603,628276,92996,124253,134913,108800,247865,131738,76831,39296,-16,4,9,-5,-6,-16,11,-11,-16,-22,58,-8,-3
2014,WV,3,62688,77713,140401,1,d,211741,104099,107642,605818,568571,37247,428781,65151,363630,605818,93243,114726,130865,112356,245277,159193,60911,25173,-16,4,9,-5,-6,-16,11,-11,-16,-22,64,-8,-3
2014,WY,1,37803,113038,171153,1,r,291938,148520,143418,584153,531680,52473,388962,103333,285629,584153,110400,107353,117721,80332,232594,102502,74451,55641,-16,4,9,-5,-6,-16,11,-11,-16,-22,29,-8,-4
2016,AK,1,111019,155088,308198,1,r,531845,280943,250902,741894,477895,263999,478951,141577,337374,741894,159890,138935,142555,75832,248468,75645,82171,90652,-12,10,12,-2,-10,-8,14,-4,-7,-22,43,-6,3
2016,AL,1,0,208083,215893,1,r,536469,253666,282803,704457,474871,229586,483628,116254,367374,704457,114951,130270,142020,120999,264399,139192,74733,50474,-12,10,12,-2,-10,-8,14,-4,-7,-22,71,-6,3
2016,AL,2,112089,134886,276584,1,r,517398,247338,270060,681621,429562,252059,464210,101169,363041,681621,120373,127381,133228,109957,259766,145197,72917,41652,-12,10,12,-2,-10,-8,14,-4,-7,-22,72,-6,3
2016,AL,3,94549,192164,287104,1,r,539625,256140,283485,709482,492798,216684,472077,107485,364592,709482,124361,133481,139231,109732,270850,143253,83491,44106,-12,10,12,-2,-10,-8,14,-4,-7,-22,70,-6,4
2016,AL,4,0,235925,239444,1,r,513264,247056,266208,683273,603756,79517,472340,80421,391919,683273,102723,129734,138901,121954,256036,148959,71972,35105,-12,10,12,-2,-10,-8,14,-4,-7,-22,56,-6,3
2016,AL,5,102234,205647,308326,1,r,538564,259555,279009,712529,541334,171195,490229,148398,341831,712529,116031,141132,145736,112419,278329,133760,79986,64583,-12,10,12,-2,-10,-8,14,-4,-7,-22,65,-6,4
2016,AL,6,83709,245313,329306,0,r,520618,247193,273425,706308,554343,151965,483675,177689,305986,706308,116386,141893,139205,109071,267123,109483,84358,73282,-12,10,12,-2,-10,-8,14,-4,-7,-22,63,-6,4
2016,AL,7,229330,0,233028,1,d,504291,231719,272572,665630,219720,445910,434554,84106,350448,665630,120264,117187,127792,99820,256015,161948,64734,29333,-12,10,12,-2,-10,-8,14,-4,-7,-22,75,-6,4
2016,AR,1,0,183866,241047,1,r,549962,271774,278188,725733,564015,161718,494346,81369,412977,725733,111901,134251,142177,129016,273559,160546,80218,32795,-12,10,12,-2,-10,-8,14,-4,-7,-22,70,-6,3
2016,AR,2,111347,176472,302464,0,r,561808,265903,295905,758929,538884,220045,504429,151196,353233,758929,134559,142076,143393,113813,293331,147850,87099,58382,-12,10,12,-2,-10,-8,14,-4,-7,-22,68,-6,4
2016,AR,3,0,217192,280907,1,r,549047,268802,280245,794237,659604,134633,510509,137205,373304,794237,141532,150529,137114,112461,303127,157968,85824,59335,-12,10,12,-2,-10,-8,14,-4,-7,-22,41,-6,4
2016,AR,4,0,182885,244159,1,r,532400,255135,277265,709349,527563,181786,481164,76063,405101,709349,97839,127626,145071,130340,272701,164554,74459,33688,-12,10,12,-2,-10,-8,14,-4,-7,-22,68,-6,3
2016,AZ,1,142219,121745,280710,0,d,557842,280243,277599,766924,501533,265391,498856,122347,376509,766924,118614,131529,138886,136102,249358,123318,79351,46689,-12,10,12,-2,-10,-8,14,-4,-7,-22,40,-6,4
2016,AZ,2,135873,179806,315679,1,r,536883,260766,276117,722770,589720,133050,507105,172194,334911,722770,130660,120852,139374,151319,301297,152596,92400,56301,-12,10,12,-2,-10,-8,14,-4,-7,-22,41,-6,4
2016,AZ,3,148973,332,151035,1,d,469111,235595,233516,752284,483361,268923,449804,74054,375750,752284,139819,141978,121298,88845,242621,135520,75847,31254,-12,10,12,-2,-10,-8,14,-4,-7,-22,38,-6,3
2016,AZ,4,81296,203487,284783,1,r,583918,294068,289850,753807,661739,92068,555153,106426,448727,753807,97376,120216,151109,207590,296652,149785,97124,49743,-12,10,12,-2,-10,-8,14,-4,-7,-22,39,-6,4
2016,AZ,5,114940,205184,320124,0,r,542947,261132,281815,785110,664846,120264,523219,188459,334760,785110,125060,158055,136216,126195,274044,93264,88837,91943,-12,10,12,-2,-10,-8,14,-4,-7,-22,41,-6,4
2016,AZ,6,122866,201578,324444,1,r,552829,268236,284593,764776,647628,117148,552249,250704,301545,764776,126585,150765,163026,139135,313796,117162,92495,104139,-12,10,12,-2,-10,-8,14,-4,-7,-22,38,-6,4
2016,AZ,7,119465,39286,158811,1,d,426164,209740,216424,818387,469488,348899,475050,66621,408429,818387,171596,157794,121612,61830,245571,145462,69448,30661,-12,10,12,-2,-10,-8,14,-4,-7,-22,41,-6,3
2016,AZ,8,0,205017,298971,1,r,578017,274146,303871,782511,659281,123230,546461,160410,386051,782511,107697,140855,149440,169847,286511,109434,97829,79248,-12,10,12,-2,-10,-8,14,-4,-7,-22,42,-6,3
2016,AZ,9,169055,108350,277507,1,d,553351,274028,279323,784502,577348,207154,518512,194679,323833,784502,192507,150526,133562,88963,309202,140177,94756,74269,-12,10,12,-2,-10,-8,14,-4,-7,-22,42,-6,4
2016,CA,1,128588,185448,314036,1,r,545241,271064,274177,703162,612131,91031,494238,116944,377294,703162,110724,117108,146951,149514,273669,141719,79516,52434,-12,10,12,-2,-10,-8,14,-4,-7,-22,38,-6,3
2016,CA,10,116470,124671,241141,0,r,467217,225934,241283,744989,532992,211997,471688,78124,393564,744989,136998,141306,133155,91488,235531,98432,76573,60526,-12,10,12,-2,-10,-8,14,-4,-7,-22,37,-6,3
2016,CA,11,214868,83341,298209,1,d,490818,233983,256835,756337,464397,291940,523012,228046,294966,756337,126786,151011,151342,122299,266301,76965,72603,116733,-12,10,12,-2,-10,-8,14,-4,-7,-22,41,-6,4
2016,CA,12,274035,0,338845,1,d,565021,288845,276176,756991,369650,387341,609759,362668,247091,756991,217052,173380,137829,110833,324880,90733,62572,171575,-12,10,12,-2,-10,-8,14,-4,-7,-22,37,-6,4
2016,CA,13,293117,29754,322871,1,d,518329,246921,271408,755243,315788,439455,538034,253703,284331,755243,168640,158390,138444,104061,287921,103657,75441,108823,-12,10,12,-2,-10,-8,14,-4,-7,-22,46,-6,5
2016,CA,14,231630,54817,286447,1,d,492515,239064,253451,749041,332808,416233,539090,256233,282857,749041,138724,162387,151487,115043,253163,56264,64025,132874,-12,10,12,-2,-10,-8,14,-4,-7,-22,35,-6,4
2016,CA,15,198578,70619,269197,1,d,478329,232338,245991,769371,360658,408713,533101,239852,293249,769371,137887,171556,154563,98128,250240,55564,61465,133211,-12,10,12,-2,-10,-8,14,-4,-7,-22,36,-6,4
2016,CA,16,97473,70483,167956,1,d,396564,189965,206599,730141,423478,306663,427446,51984,375462,730141,149993,127403,112878,73482,210616,122641,55732,32243,-12,10,12,-2,-10,-8,14,-4,-7,-22,38,-6,3
2016,CA,17,233192,0,233192,0,d,437027,221951,215076,774647,222446,552201,545285,310928,234357,774647,171189,177000,135941,88555,257515,49223,53867,154425,-12,10,12,-2,-10,-8,14,-4,-7,-22,34,-6,5
2016,CA,18,230460,93470,323930,1,d,477984,232245,245739,739012,457582,281430,521738,321005,200733,739012,123606,157068,151868,113381,268446,58373,50476,159597,-12,10,12,-2,-10,-8,14,-4,-7,-22,35,-6,6
2016,CA,19,181802,64061,245863,1,d,468358,234670,233688,762005,326934,435071,504580,179283,325297,762005,149508,157033,143071,92178,226671,61828,57612,107231,-12,10,12,-2,-10,-8,14,-4,-7,-22,35,-6,3
2016,CA,2,254194,76572,330766,1,d,521949,255156,266793,716202,570621,145581,515218,210012,305206,716202,98912,138381,157430,142833,283904,110596,73956,99352,-12,10,12,-2,-10,-8,14,-4,-7,-22,37,-6,4
2016,CA,20,180980,74811,255791,0,d,430412,211819,218593,743764,471702,272062,470967,131212,339755,743764,134251,139569,132373,96340,227623,83078,72129,72416,-12,10,12,-2,-10,-8,14,-4,-7,-22,36,-6,4
2016,CA,21,57282,75126,132408,1,r,353366,190629,162737,726385,508060,218325,415361,32659,382702,726385,142367,137868,107554,62570,187890,109520,54260,24110,-12,10,12,-2,-10,-8,14,-4,-7,-22,37,-6,3
2016,CA,22,76211,158755,234966,1,r,470021,226532,243489,755289,556374,198915,466284,112423,353861,755289,143987,138404,122515,93206,241790,107899,74610,59281,-12,10,12,-2,-10,-8,14,-4,-7,-22,37,-6,3
2016,CA,23,74468,167116,241584,1,r,480647,238305,242342,725299,509317,215982,460244,95861,364383,725299,142341,131716,128662,90814,242551,111538,71949,59064,-12,10,12,-2,-10,-8,14,-4,-7,-22,40,-6,3
2016,CA,24,166034,144780,310814,0,d,502459,249660,252799,738700,587967,150733,471690,160535,311155,738700,136172,124432,132800,120565,252574,92043,81271,79260,-12,10,12,-2,-10,-8,14,-4,-7,-22,36,-6,4
2016,CA,25,122406,138755,261161,0,r,486145,241454,244691,728858,470038,258820,469945,130590,339355,728858,121511,144610,148878,83668,225209,78567,62810,83832,-12,10,12,-2,-10,-8,14,-4,-7,-22,40,-6,3
2016,CA,26,169248,111059,280307,1,d,464370,224214,240156,726532,585872,140660,481657,164343,317314,726532,126802,137412,142526,106451,228178,71046,67705,89427,-12,10,12,-2,-10,-8,14,-4,-7,-22,36,-6,4
2016,CA,27,168977,81655,250632,1,d,487915,233823,254092,724293,272728,451565,526950,213530,313420,724293,126576,146817,153858,128121,243721,88391,67638,87692,-12,10,12,-2,-10,-8,14,-4,-7,-22,36,-6,4
2016,CA,28,210883,59526,270409,1,d,501568,247542,254026,709613,470995,238618,548770,253652,295118,709613,165595,159838,138355,110917,297443,121754,81778,93911,-12,10,12,-2,-10,-8,14,-4,-7,-22,37,-6,3
2016,CA,29,171824,0,171824,1,d,403627,200000,203627,726264,418322,307942,480316,92420,387896,726264,162833,151683,131018,73622,211315,104147,61444,45724,-12,10,12,-2,-10,-8,14,-4,-7,-22,36,-6,2
2016,CA,3,152513,104453,256966,1,d,495945,242783,253162,740253,492473,247780,476942,119627,357315,740253,144025,132237,135887,102473,251190,101522,79890,69778,-12,10,12,-2,-10,-8,14,-4,-7,-22,40,-6,4
2016,CA,30,205279,77325,282604,1,d,526139,253464,272675,759943,517383,242560,544636,231174,313462,759943,147294,159313,154250,117517,275641,91211,77393,107037,-12,10,12,-2,-10,-8,14,-4,-7,-22,40,-6,3
2016,CA,31,121070,94866,215936,1,d,464030,220967,243063,742627,456559,286068,459112,104034,355078,742627,156006,140533,122316,78000,222147,97479,70317,54351,-12,10,12,-2,-10,-8,14,-4,-7,-22,41,-6,3
2016,CA,32,186646,0,186646,1,d,446836,220384,226452,719488,290839,428649,481632,102899,378733,719488,145148,140342,135520,97238,191240,72471,63323,55446,-12,10,12,-2,-10,-8,14,-4,-7,-22,36,-6,2
2016,CA,33,219397,110822,330219,1,d,526781,253564,273217,712919,517760,195159,524077,342650,181427,712919,126189,147792,149378,121818,301954,76512,68844,156598,-12,10,12,-2,-10,-8,14,-4,-7,-22,37,-6,4
2016,CA,34,159156,0,159156,1,d,396135,198113,198022,758622,316876,441746,519291,131887,387404,758622,186369,161694,125955,85302,255952,149660,64695,41597,-12,10,12,-2,-10,-8,14,-4,-7,-22,36,-6,2
2016,CA,35,124044,47309,171353,1,d,432760,216551,216209,744729,344122,400607,460314,73909,386405,744729,156917,150089,125059,67282,191182,81447,67061,42674,-12,10,12,-2,-10,-8,14,-4,-7,-22,38,-6,2
2016,CA,36,144348,88269,232617,1,d,477984,234668,243316,749841,515188,234653,517881,106785,411096,749841,111789,132616,137905,158597,267899,145925,70040,51934,-12,10,12,-2,-10,-8,14,-4,-7,-22,38,-6,4
2016,CA,37,237272,0,237272,1,d,469142,223832,245310,729010,305751,423259,509036,187804,321232,729010,175000,149472,129749,94620,273317,127410,71988,73919,-12,10,12,-2,-10,-8,14,-4,-7,-22,48,-6,4
2016,CA,38,163590,68524,232114,1,d,459617,220359,239258,708889,304070,404819,470664,110537,360127,708889,128929,143131,132897,95428,204335,76451,64585,63299,-12,10,12,-2,-10,-8,14,-4,-7,-22,37,-6,2
2016,CA,39,112679,150777,263456,1,r,481935,235883,246052,729909,353478,376431,500329,208230,292099,729909,141376,140523,147155,107337,225793,62013,67718,96062,-12,10,12,-2,-10,-8,14,-4,-7,-22,35,-6,3
2016,CA,4,130845,220133,350978,1,r,554398,273806,280592,737169,622130,115039,525139,174748,350391,737169,95723,136727,163762,147979,274386,94138,80159,100089,-12,10,12,-2,-10,-8,14,-4,-7,-22,37,-6,3
2016,CA,40,106554,0,149297,1,d,333524,159739,173785,723345,358263,365082,429765,42146,387619,723345,146912,145789,109362,64064,182996,104569,53121,25306,-12,10,12,-2,-10,-8,14,-4,-7,-22,36,-6,2
2016,CA,41,128164,69159,197323,1,d,452955,217190,235765,760165,349650,410515,451297,82464,368833,760165,158679,142225,121402,70626,194812,78592,66972,49248,-12,10,12,-2,-10,-8,14,-4,-7,-22,40,-6,4
2016,CA,42,104689,149547,254236,1,r,525046,265237,259809,793044,488486,304558,513020,128489,384531,793044,144076,161696,143196,94716,227143,72056,72482,82605,-12,10,12,-2,-10,-8,14,-4,-7,-22,39,-6,3
2016,CA,43,167017,52499,219516,1,d,428712,198207,230505,724077,244752,479325,479623,127283,352340,724077,150107,150020,130138,84149,239020,110710,67906,60404,-12,10,12,-2,-10,-8,14,-4,-7,-22,45,-6,3
2016,CA,44,178413,0,178413,0,d,385452,179692,205760,723685,323837,399848,443139,54688,388451,723685,142034,141659,116932,76081,188841,92833,55933,40075,-12,10,12,-2,-10,-8,14,-4,-7,-22,42,-6,3
2016,CA,45,129231,182618,311849,1,r,524363,253629,270734,774130,486619,287511,531901,297625,234276,774130,125401,166632,153060,111655,276707,69766,70605,136336,-12,10,12,-2,-10,-8,14,-4,-7,-22,34,-6,4
2016,CA,46,164593,0,164593,0,d,378269,185580,192689,736031,436360,299671,462893,86500,376393,736031,165952,146423,118525,70059,185670,72376,65363,47931,-12,10,12,-2,-10,-8,14,-4,-7,-22,35,-6,2
2016,CA,47,154759,88109,242868,1,d,467269,225645,241624,714311,375467,338844,481292,154012,327280,714311,143628,147705,135092,89256,239498,92000,74128,73370,-12,10,12,-2,-10,-8,14,-4,-7,-22,39,-6,3
2016,CA,48,127715,178701,306416,0,r,523192,254102,269090,727100,506299,220801,525500,234171,291329,727100,130342,142269,159005,123244,265180,72842,74583,117755,-12,10,12,-2,-10,-8,14,-4,-7,-22,35,-6,3
2016,CA,49,154267,155888,310155,1,r,513299,256780,256519,739697,602947,136750,492326,216720,275606,739697,135195,140336,141166,109357,256731,78047,71526,107158,-12,10,12,-2,-10,-8,14,-4,-7,-22,37,-6,4
2016,CA,5,224526,67565,292091,1,d,516338,246467,269871,735968,457424,278544,519097,162012,357085,735968,128673,143922,155219,122933,262302,86693,82524,93085,-12,10,12,-2,-10,-8,14,-4,-7,-22,40,-6,3
2016,CA,50,103646,179937,283583,1,r,500665,248977,251688,751527,565672,185855,500105,140813,359292,751527,134928,142643,149172,104789,238443,81919,75743,80781,-12,10,12,-2,-10,-8,14,-4,-7,-22,39,-6,3
2016,CA,51,145162,54362,199524,1,d,423815,217920,205895,747202,497387,249815,469521,66296,403225,747202,164155,137308,123833,85062,201097,105981,62864,32252,-12,10,12,-2,-10,-8,14,-4,-7,-22,38,-6,2
2016,CA,52,181253,139403,320656,1,d,538549,272094,266455,750537,522076,228461,525905,301916,223989,750537,166551,153822,135907,107795,281618,77479,76409,127730,-12,10,12,-2,-10,-8,14,-4,-7,-22,37,-6,4
2016,CA,53,198988,97968,296956,1,d,537673,268751,268922,766812,497068,269744,530649,200803,329846,766812,185499,155763,132609,98161,268519,94812,85116,88591,-12,10,12,-2,-10,-8,14,-4,-7,-22,40,-6,3
2016,CA,6,177565,57848,235413,1,d,507502,244232,263270,763987,399978,364009,505811,139223,366588,763987,174511,143618,131518,93034,271977,129986,81461,60530,-12,10,12,-2,-10,-8,14,-4,-7,-22,44,-6,3
2016,CA,7,152133,145168,297301,1,d,515336,246842,268494,738468,465884,272584,501496,165065,336431,738468,123848,150180,145992,110199,261127,92142,82704,86281,-12,10,12,-2,-10,-8,14,-4,-7,-22,42,-6,3
2016,CA,8,83035,136972,220007,1,r,480794,239596,241198,723600,548716,174884,452986,77408,375578,723600,126691,129754,134695,93345,232951,117835,68266,46850,-12,10,12,-2,-10,-8,14,-4,-7,-22,42,-6,4
2016,CA,9,133163,98992,232155,1,d,473461,228501,244960,760794,415860,344934,483489,92545,390944,760794,133111,146561,136297,98254,237359,97430,71406,68523,-12,10,12,-2,-10,-8,14,-4,-7,-22,41,-6,3
2016,CO,1,257254,105030,379036,1,d,584194,289316,294878,812843,629230,183613,578533,275617,302916,812843,203637,172065,137522,96312,339619,133169,103402,103048,-12,10,12,-2,-10,-8,14,-4,-7,-22,44,-6,4
2016,CO,2,260175,170001,457312,1,d,617595,311123,306472,803470,721991,81479,543097,294655,248442,803470,158163,155072,162402,112571,311376,103918,94920,112538,-12,10,12,-2,-10,-8,14,-4,-7,-22,38,-6,4
2016,CO,3,150914,204220,374037,1,r,547569,272495,275074,738119,655140,82979,506754,148175,358579,738119,119780,135807,153712,128116,285496,140304,89329,55863,-12,10,12,-2,-10,-8,14,-4,-7,-22,37,-6,3
2016,CO,4,123642,248230,390633,1,r,555378,278879,276499,795836,731835,64001,522548,182553,339995,795836,125130,162051,155078,105731,290279,106453,91092,92734,-12,10,12,-2,-10,-8,14,-4,-7,-22,37,-6,3
2016,CO,5,111676,225445,361993,1,r,578762,296021,282741,786939,642994,143945,518201,191745,326456,786939,159987,146767,149084,104013,295699,118752,96847,80100,-12,10,12,-2,-10,-8,14,-4,-7,-22,46,-6,4
2016,CO,6,160372,191626,376417,1,r,542332,263897,278435,813566,584127,229439,540632,226158,314474,813566,149612,177855,152707,94698,289521,86834,96982,105705,-12,10,12,-2,-10,-8,14,-4,-7,-22,46,-6,4
2016,CO,7,199758,144066,362010,1,d,553448,275468,277980,789772,689604,100168,535741,173978,361763,789772,162176,156005,148759,101615,297002,106421,107130,83451,-12,10,12,-2,-10,-8,14,-4,-7,-22,38,-6,3
2016,CT,1,187021,105674,312925,1,d,516508,240179,276329,712461,492998,219463,491367,180706,310661,712461,120554,137750,145644,114582,277215,102425,81311,93479,-12,10,12,-2,-10,-8,14,-4,-7,-22,52,-6,4
2016,CT,2,186210,111149,330257,1,d,548989,275164,273825,705034,609068,95966,485553,170534,315019,705034,113287,129481,156435,118632,268254,87406,86446,94402,-12,10,12,-2,-10,-8,14,-4,-7,-22,47,-6,4
2016,CT,3,192274,95786,309379,1,d,532027,251919,280108,717162,520873,196289,496087,179352,316735,717162,129556,133495,149251,114111,274137,104292,82144,87701,-12,10,12,-2,-10,-8,14,-4,-7,-22,52,-6,5
2016,CT,4,187811,120653,313540,1,d,480429,228722,251707,732469,536758,195711,493269,240946,252323,732469,111497,148277,154761,105365,258126,77116,56850,124160,-12,10,12,-2,-10,-8,14,-4,-7,-22,49,-6,5
2016,CT,5,163499,124900,309082,0,d,524832,252045,272787,709326,582195,127131,501461,182050,319411,709326,106226,137853,161553,123950,279537,104285,80401,94851,-12,10,12,-2,-10,-8,14,-4,-7,-22,45,-6,4
2016,DC,1,0,0,0,0,,513470,239366,274104,681170,277268,403902,480158,272875,207283,681170,190699,137713,108685,79097,281241,103692,64355,113194,-12,10,12,-2,-10,-8,14,-4,-7,-22,67,-6,7
2016,DE,1,233554,172301,420617,0,d,705209,334269,370940,952065,659091,292974,662547,205069,457478,952065,163112,172949,194354,166674,351085,142864,113611,94610,-12,10,12,-2,-10,-8,14,-4,-7,-22,61,-6,4
2016,FL,1,114079,255107,369186,0,r,583096,293817,289279,762506,585415,177091,522481,145734,376747,762506,138503,138536,153104,124045,287528,135327,90813,61388,-12,10,12,-2,-10,-8,14,-4,-7,-22,59,-6,3
2016,FL,10,198491,107498,305989,0,r,516249,248958,267291,791447,451551,339896,539334,163558,375776,791447,175446,164912,147627,89364,283982,141424,84920,57638,-12,10,12,-2,-10,-8,14,-4,-7,-22,54,-6,3
2016,FL,11,124713,258016,394719,0,r,623539,297540,325999,758331,659339,98992,598985,123148,475837,758331,81332,104183,151526,276821,316699,175208,100055,41436,-12,10,12,-2,-10,-8,14,-4,-7,-22,54,-6,4
2016,FL,12,116110,253559,369669,1,r,588899,279399,309500,760472,673398,87074,564720,151864,412856,760472,97829,139757,160714,186455,301046,150959,89843,60244,-12,10,12,-2,-10,-8,14,-4,-7,-22,45,-6,3
2016,FL,13,184693,171149,355842,0,r,573748,274359,299389,728996,575932,153064,553105,153692,399413,728996,118292,132644,165300,161948,306391,156696,88463,61232,-12,10,12,-2,-10,-8,14,-4,-7,-22,55,-6,3
2016,FL,14,195789,121088,316877,1,d,523326,245138,278188,769968,530438,239530,519979,183328,336651,769968,158280,156112,143649,98322,299832,144876,85554,69402,-12,10,12,-2,-10,-8,14,-4,-7,-22,51,-6,4
2016,FL,15,135475,182999,318474,1,r,550776,266140,284636,762822,580409,182413,524599,135105,389494,762822,134539,149104,145434,122714,266358,122515,92033,51810,-12,10,12,-2,-10,-8,14,-4,-7,-22,50,-6,3
2016,FL,16,155262,230654,385916,1,r,592935,277569,315366,803454,672814,130640,593246,182241,411005,803454,106224,138288,163258,208494,310488,141108,93495,75885,-12,10,12,-2,-10,-8,14,-4,-7,-22,48,-6,4
2016,FL,17,115974,209348,338675,1,r,594045,290609,303436,768138,666637,101501,585592,124505,461087,768138,87466,119040,158293,236110,289543,156247,88157,45139,-12,10,12,-2,-10,-8,14,-4,-7,-22,48,-6,3
2016,FL,18,161918,201488,375918,0,d,565416,271930,293486,754652,613642,141010,556229,169611,386618,754652,98585,132502,158109,189671,291685,131391,91155,69139,-12,10,12,-2,-10,-8,14,-4,-7,-22,52,-6,3
2016,FL,19,123812,239225,363166,0,r,595146,283828,311318,799332,687450,111882,606630,196060,410570,799332,104708,126837,160285,238368,303841,136001,94923,72917,-12,10,12,-2,-10,-8,14,-4,-7,-22,47,-6,4
2016,FL,2,102801,231163,343362,0,d,559733,287567,272166,720418,588570,131848,511849,119723,392126,720418,114649,130598,154747,138222,265352,141039,80546,43767,-12,10,12,-2,-10,-8,14,-4,-7,-22,60,-6,4
2016,FL,20,222914,54646,277560,1,d,487186,229927,257259,794621,314070,480551,529350,104269,425081,794621,152417,163319,146019,103839,242271,135364,70234,36673,-12,10,12,-2,-10,-8,14,-4,-7,-22,62,-6,3
2016,FL,21,210606,118038,335861,0,d,530834,243801,287033,758201,582382,175819,558261,191317,366944,758201,111960,135471,143557,190709,282081,126049,84530,71502,-12,10,12,-2,-10,-8,14,-4,-7,-22,51,-6,4
2016,FL,22,199113,138737,337850,0,d,523064,255413,267651,737019,553571,183448,549033,207943,341090,737019,110734,141880,162788,153272,302908,129349,86794,86765,-12,10,12,-2,-10,-8,14,-4,-7,-22,52,-6,4
2016,FL,23,183225,130818,323120,1,d,516288,244016,272272,749377,556073,193304,537363,207312,330051,749377,129644,153945,154089,130175,274257,113272,79706,81279,-12,10,12,-2,-10,-8,14,-4,-7,-22,45,-6,4
2016,FL,24,0,0,0,0,d,454554,217918,236636,749624,316828,432796,515286,99775,415511,749624,152352,149537,145152,103319,241659,151028,60718,29913,-12,10,12,-2,-10,-8,14,-4,-7,-22,58,-6,3
2016,FL,25,95319,157921,253240,1,r,429392,196863,232529,763628,683958,79670,552238,125576,426662,763628,117948,162328,149404,146409,241411,127046,72539,41826,-12,10,12,-2,-10,-8,14,-4,-7,-22,37,-6,3
2016,FL,26,115493,148547,280542,1,r,471091,222240,248851,788816,640954,147862,540331,147104,393227,788816,140524,165947,150965,114391,224504,103145,71518,49841,-12,10,12,-2,-10,-8,14,-4,-7,-22,41,-6,3
2016,FL,27,129760,157917,287677,1,r,446183,215392,230791,747049,638792,108257,555585,208159,347426,747049,138445,158082,148207,136402,280067,134682,70613,74772,-12,10,12,-2,-10,-8,14,-4,-7,-22,38,-6,5
2016,FL,3,136338,193843,342700,1,r,555481,270896,284585,732088,558389,173699,484134,125181,358953,732088,136443,131238,137902,118186,261185,141042,73522,46621,-12,10,12,-2,-10,-8,14,-4,-7,-22,58,-6,4
2016,FL,4,113088,287509,409662,0,r,588201,285662,302539,778620,638296,140324,552993,216890,336103,778620,147431,153311,159983,124622,297592,102593,102065,92934,-12,10,12,-2,-10,-8,14,-4,-7,-22,50,-6,3
2016,FL,5,194549,108325,302874,0,d,535990,251884,284106,728346,327600,400746,459280,98332,360948,728346,158725,131794,124072,89439,265998,158949,77175,29874,-12,10,12,-2,-10,-8,14,-4,-7,-22,69,-6,3
2016,FL,6,151051,213519,364570,1,r,605269,288687,316582,765005,643603,121402,565719,135170,430549,765005,106534,127403,165155,191808,302322,160233,93337,48752,-12,10,12,-2,-10,-8,14,-4,-7,-22,53,-6,3
2016,FL,7,182039,171583,353655,1,r,569820,275278,294542,762326,593834,168492,517490,195371,322119,762326,152907,150186,143462,104584,279904,122066,87776,70062,-12,10,12,-2,-10,-8,14,-4,-7,-22,46,-6,3
2016,FL,8,127127,246483,390561,1,r,584514,280880,303634,744430,619383,125047,552204,160035,392169,744430,103604,121730,166944,184734,286448,140287,86237,59924,-12,10,12,-2,-10,-8,14,-4,-7,-22,53,-6,4
2016,FL,9,195311,144450,339761,0,d,567787,273638,294149,832753,620837,211916,557655,137453,420202,832753,146299,166137,147412,128341,268104,134276,87667,46161,-12,10,12,-2,-10,-8,14,-4,-7,-22,46,-6,3
2016,GA,1,0,210243,211112,0,r,541106,264488,276618,734172,462488,271684,482609,120661,361948,734172,140010,136751,132502,105099,267317,130299,84566,52452,-12,10,12,-2,-10,-8,14,-4,-7,-22,67,-6,3
2016,GA,10,0,243725,244821,1,r,547079,263612,283467,741464,509454,232010,467757,124708,343049,741464,120400,142076,136015,104055,253432,123313,77307,52812,-12,10,12,-2,-10,-8,14,-4,-7,-22,66,-6,5
2016,GA,11,105383,217935,323318,0,r,520129,247499,272630,764184,556071,208113,506101,207397,298704,764184,141455,164087,143715,88732,280307,97335,89436,93536,-12,10,12,-2,-10,-8,14,-4,-7,-22,57,-6,3
2016,GA,12,99420,159492,258912,0,r,534229,261809,272420,719970,419272,300698,470113,98144,371969,719970,132367,135182,132110,99469,252350,140982,71323,40045,-12,10,12,-2,-10,-8,14,-4,-7,-22,69,-6,4
2016,GA,13,252833,0,252833,1,d,501289,223229,278060,746218,227609,518609,477558,141442,336116,746218,132888,158306,136325,81276,257261,111778,90846,54637,-12,10,12,-2,-10,-8,14,-4,-7,-22,69,-6,4
2016,GA,14,0,216743,216743,1,r,500931,240865,260066,710176,599215,110961,470799,85242,385557,710176,109923,144970,133336,105764,253245,128926,82243,42076,-12,10,12,-2,-10,-8,14,-4,-7,-22,54,-6,3
2016,GA,2,148543,94056,242599,0,d,494954,236869,258085,672244,284006,388238,439495,77502,361993,672244,118286,121132,126633,98510,244541,155393,59339,29809,-12,10,12,-2,-10,-8,14,-4,-7,-22,73,-6,4
2016,GA,3,95969,207218,303187,0,r,535721,251442,284279,729810,502554,227256,486651,128811,357840,729810,115358,147368,142761,106341,263782,117491,85899,60392,-12,10,12,-2,-10,-8,14,-4,-7,-22,67,-6,4
2016,GA,4,220146,70593,290739,0,d,499073,223460,275613,752273,226266,526007,491496,146690,344806,752273,141353,152666,145810,81335,264468,126550,84897,53021,-12,10,12,-2,-10,-8,14,-4,-7,-22,69,-6,4
2016,GA,5,253781,46768,300549,1,d,557613,270427,287186,747809,238907,508902,503168,211450,291718,747809,179922,152188,122939,83934,298413,151470,80380,66563,-12,10,12,-2,-10,-8,14,-4,-7,-22,70,-6,5
2016,GA,6,124917,201088,326005,1,r,489366,232719,256647,756004,511912,244092,519292,314618,204674,756004,124761,171824,156695,90282,283001,74487,83529,124985,-12,10,12,-2,-10,-8,14,-4,-7,-22,50,-6,4
2016,GA,7,114220,174081,288301,1,r,469166,223652,245514,789864,424829,365035,505813,200524,305289,789864,124299,186822,147614,78100,256978,86298,84467,86213,-12,10,12,-2,-10,-8,14,-4,-7,-22,50,-6,3
2016,GA,8,83225,173983,257208,1,r,521291,250103,271188,710108,450574,259534,467468,101832,365636,710108,125390,135401,132390,105153,256041,141694,70578,43769,-12,10,12,-2,-10,-8,14,-4,-7,-22,69,-6,4
2016,GA,9,0,256535,256535,1,r,529334,254453,274881,736075,641704,94371,497075,107255,389820,736075,108373,138601,146292,131084,254999,127028,80059,47912,-12,10,12,-2,-10,-8,14,-4,-7,-22,50,-6,4
2016,HI,1,145417,45958,213531,0,d,500190,255574,244616,706501,123477,583024,500083,180141,319942,706501,138571,136609,130319,125737,230958,70083,73360,87515,-12,10,12,-2,-10,-8,14,-4,-7,-22,33,-6,3
2016,HI,2,170848,39668,224133,1,d,518441,263320,255121,722056,234517,487539,490854,136452,354402,722056,132631,131554,143070,117804,224910,78303,70045,76562,-12,10,12,-2,-10,-8,14,-4,-7,-22,34,-6,3
2016,IA,1,177403,206903,384977,1,r,579936,284815,295121,771008,705007,66001,515115,139494,375621,771008,127579,135966,153691,132464,307410,133357,106546,67507,-12,10,12,-2,-10,-8,14,-4,-7,-22,53,-6,3
2016,IA,2,198571,170933,370032,1,d,582071,284982,297089,778964,698797,80167,519381,147809,371572,778964,131816,141078,150728,127955,308367,146890,97596,63881,-12,10,12,-2,-10,-8,14,-4,-7,-22,50,-6,4
2016,IA,3,155002,208598,390287,1,r,592785,287240,305545,824082,726471,97611,548951,181728,367223,824082,143643,161791,157075,115548,321446,127476,107163,86807,-12,10,12,-2,-10,-8,14,-4,-7,-22,48,-6,3
2016,IA,4,142993,226719,370259,1,r,566140,279045,287095,760639,703887,56752,503573,124131,379442,760639,117711,126629,151268,137775,310709,145288,104394,61027,-12,10,12,-2,-10,-8,14,-4,-7,-22,43,-6,3
2016,ID,1,113052,242252,355357,1,r,631651,314191,317460,864758,775188,89570,571282,145198,426084,864758,131124,158885,166457,143123,315763,149850,106244,59669,-12,10,12,-2,-10,-8,14,-4,-7,-22,36,-6,3
2016,ID,2,95940,205292,326237,1,r,559611,275061,284550,818382,734931,83451,515983,155212,360771,818382,153026,146022,139183,113039,295109,143950,92782,58377,-12,10,12,-2,-10,-8,14,-4,-7,-22,37,-6,3
2016,IL,1,234037,81817,315862,1,d,517212,232621,284591,691474,292771,398703,472483,136648,335835,691474,121143,128084,143681,107751,265181,131473,71894,61814,-12,10,12,-2,-10,-8,14,-4,-7,-22,69,-6,4
2016,IL,10,150435,135535,285996,0,r,454930,222784,232146,710610,505898,204712,467972,206168,261804,710610,114997,142055,139783,100381,251252,84196,72538,94518,-12,10,12,-2,-10,-8,14,-4,-7,-22,41,-6,4
2016,IL,11,166578,108995,275573,1,d,475114,227357,247757,730480,478688,251792,471623,169844,301779,730480,124630,158711,133591,86247,251942,87112,78833,85997,-12,10,12,-2,-10,-8,14,-4,-7,-22,45,-6,4
2016,IL,12,124246,169976,313002,1,r,528720,258045,270675,693736,541201,152535,477135,114286,362849,693736,119835,129812,141475,113497,277601,145084,77777,54740,-12,10,12,-2,-10,-8,14,-4,-7,-22,67,-6,4
2016,IL,13,126811,187583,314394,1,r,545235,265475,279760,704699,573421,131278,462288,139793,322495,704699,134091,121998,136080,109875,283971,142453,83849,57669,-12,10,12,-2,-10,-8,14,-4,-7,-22,60,-6,4
2016,IL,14,137589,200508,338097,1,r,516115,251643,264472,736397,636375,100022,480043,202100,277943,736397,101951,156069,154453,92802,250357,65348,75634,109375,-12,10,12,-2,-10,-8,14,-4,-7,-22,42,-6,3
2016,IL,15,0,274554,274554,1,r,535966,264281,271685,700549,648770,51779,483638,97679,385959,700549,109738,130267,141684,125770,275299,137808,88533,48958,-12,10,12,-2,-10,-8,14,-4,-7,-22,60,-6,3
2016,IL,16,0,259722,259853,1,r,521802,256509,265293,687998,623579,64419,472433,104768,367665,687998,105774,130807,142529,121540,270748,117517,91468,61763,-12,10,12,-2,-10,-8,14,-4,-7,-22,46,-6,4
2016,IL,17,173125,113943,287068,1,d,519185,252351,266834,691212,565738,125474,471381,88043,383338,691212,111349,123362,140374,123007,283430,153362,86502,43566,-12,10,12,-2,-10,-8,14,-4,-7,-22,57,-6,3
2016,IL,18,96770,250506,347283,0,r,539318,262256,277062,713402,647359,66043,491185,155595,335590,713402,106598,137033,144096,127190,283990,114296,94624,75070,-12,10,12,-2,-10,-8,14,-4,-7,-22,53,-6,3
2016,IL,2,235051,59471,294522,1,d,515080,234694,280386,713917,264797,449120,463595,108193,355402,713917,117988,134378,140034,106110,263915,135502,81433,46980,-12,10,12,-2,-10,-8,14,-4,-7,-22,69,-6,4
2016,IL,3,225320,0,225411,1,d,478046,234097,243949,720930,529893,191037,482264,129870,352394,720930,124283,140701,147405,98022,244418,94959,77588,71871,-12,10,12,-2,-10,-8,14,-4,-7,-22,40,-6,3
2016,IL,4,171297,0,171297,1,d,381076,189377,191699,695098,385144,309954,451637,110659,340978,695098,156744,148701,112932,65588,223350,107556,68753,47041,-12,10,12,-2,-10,-8,14,-4,-7,-22,37,-6,3
2016,IL,5,212842,86222,313724,1,d,524251,252961,271290,723373,593685,129688,522238,285599,236639,723373,200738,149200,121837,90566,297889,93248,86531,118110,-12,10,12,-2,-10,-8,14,-4,-7,-22,38,-6,4
2016,IL,6,143591,208555,352146,1,r,519359,252059,267300,722323,599312,123011,494532,258089,236443,722323,109773,140701,162657,105742,262303,67055,67326,127922,-12,10,12,-2,-10,-8,14,-4,-7,-22,39,-6,4
2016,IL,7,250584,46882,297466,1,d,520978,240020,280958,723481,256647,466834,501103,203830,297273,723481,185968,141670,126101,87228,295886,137169,71656,87061,-12,10,12,-2,-10,-8,14,-4,-7,-22,62,-6,5
2016,IL,8,144954,103617,248571,0,d,445289,220010,225279,717789,465992,251797,487770,158928,328842,717789,129490,153605,139402,91052,253677,88690,88154,76833,-12,10,12,-2,-10,-8,14,-4,-7,-22,38,-6,3
2016,IL,9,217306,109550,326948,1,d,500782,238712,262070,724071,514493,209578,511899,272193,239706,724071,122365,145547,145812,120462,286837,110746,77193,98898,-12,10,12,-2,-10,-8,14,-4,-7,-22,45,-6,4
2016,IN,1,207515,0,254583,1,d,530139,257043,273096,711958,495472,216486,481858,108962,372896,711958,117373,138284,144159,110679,270418,120320,88270,61828,-12,10,12,-2,-10,-8,14,-4,-7,-22,57,-6,3
2016,IN,2,102401,164355,277357,1,r,519130,250814,268316,724060,627056,97004,474369,98542,375827,724060,113090,133375,141565,111847,265086,129022,93305,42759,-12,10,12,-2,-10,-8,14,-4,-7,-22,52,-6,3
2016,IN,3,66023,201396,287247,0,r,532343,258029,274314,740262,649021,91241,482856,110492,372364,740262,121329,135766,143242,110701,282012,136446,95483,50083,-12,10,12,-2,-10,-8,14,-4,-7,-22,54,-6,3
2016,IN,4,91256,193412,299434,1,r,552328,273489,278839,749049,663509,85540,483085,125496,357589,749049,134357,136546,142701,110890,286048,131109,94360,60579,-12,10,12,-2,-10,-8,14,-4,-7,-22,49,-6,4
2016,IN,5,123849,221957,361135,1,r,561410,267902,293508,768412,651499,116913,518432,233083,285349,768412,134084,154100,149113,110184,304370,115848,92050,96472,-12,10,12,-2,-10,-8,14,-4,-7,-22,55,-6,3
2016,IN,6,79135,204920,296385,1,r,548268,267638,280630,720656,669635,51021,486573,100795,385778,720656,115886,133919,146667,122288,280264,136679,93642,49943,-12,10,12,-2,-10,-8,14,-4,-7,-22,53,-6,4
2016,IN,7,158739,94456,264670,1,d,508847,237265,271582,751554,437278,314276,484437,113627,370810,751554,154834,143931,135740,83038,285276,164875,81349,39052,-12,10,12,-2,-10,-8,14,-4,-7,-22,64,-6,3
2016,IN,8,93356,187702,294713,1,r,546191,268528,277663,717028,656813,60215,485301,103263,382038,717028,117872,128944,147035,119857,281301,139753,92407,49141,-12,10,12,-2,-10,-8,14,-4,-7,-22,59,-6,3
2016,IN,9,130627,174791,322843,0,r,568649,276314,292335,750074,686135,63939,495665,130586,365079,750074,130458,140482,146180,113855,278495,127144,92873,58478,-12,10,12,-2,-10,-8,14,-4,-7,-22,48,-6,4
2016,KS,1,0,169992,257971,0,r,501460,252362,249098,708078,631156,76922,447354,106869,340485,708078,127288,118269,127298,111819,269153,139349,89813,39991,-12,10,12,-2,-10,-8,14,-4,-7,-22,42,-6,3
2016,KS,2,96840,181228,297401,1,r,542206,267202,275004,716597,618279,98318,471009,137586,333423,716597,117265,125985,139102,118918,277244,134134,89766,53344,-12,10,12,-2,-10,-8,14,-4,-7,-22,52,-6,4
2016,KS,3,139300,176022,343113,1,r,522479,251534,270945,759978,613550,146428,503512,238459,265053,759978,132060,155220,144243,100022,288299,102770,86608,98921,-12,10,12,-2,-10,-8,14,-4,-7,-22,49,-6,4
2016,KS,4,81495,166998,275251,1,r,511766,250788,260978,722636,595981,126655,470061,138512,331549,722636,123814,129129,137850,106912,275711,132219,85919,57573,-12,10,12,-2,-10,-8,14,-4,-7,-22,49,-6,3
2016,KY,1,81710,216959,299001,0,r,549962,269589,280373,717739,639695,78044,485520,76111,409409,717739,111519,129838,145437,126588,278896,165989,78647,34260,-12,10,12,-2,-10,-8,14,-4,-7,-22,66,-6,4
2016,KY,2,0,251825,251825,1,r,568742,276256,292486,754967,672175,82792,500359,104499,395860,754967,117544,146878,149027,113993,284181,142188,90806,51187,-12,10,12,-2,-10,-8,14,-4,-7,-22,60,-6,4
2016,KY,3,212401,122093,334494,1,d,551872,260748,291124,740860,530806,210054,512367,158342,354025,740860,139494,138871,148877,113692,305947,149457,94547,61943,-12,10,12,-2,-10,-8,14,-4,-7,-22,66,-6,4
2016,KY,4,94065,233922,327987,1,r,559925,273520,286405,754502,693615,60887,506069,143174,362895,754502,120750,155065,151599,107756,280953,115929,88903,76121,-12,10,12,-2,-10,-8,14,-4,-7,-22,55,-6,3
2016,KY,5,0,221242,221242,1,r,543365,264600,278765,703315,680953,22362,486901,60537,426364,703315,107167,137511,146595,119230,270305,184815,60009,25481,-12,10,12,-2,-10,-8,14,-4,-7,-22,56,-6,5
2016,KY,6,128728,202099,330827,1,r,568438,271443,296995,765591,649089,116502,504293,159678,344615,765591,139214,146713,146847,106266,297424,146276,91741,59407,-12,10,12,-2,-10,-8,14,-4,-7,-22,59,-6,4
2016,LA,1,63785,243645,326788,1,r,591994,282425,309569,803427,628111,175316,545519,165469,380050,803427,138464,152199,161024,123277,301862,132818,92139,76905,-12,10,12,-2,-10,-8,14,-4,-7,-22,59,-6,3
2016,LA,2,284269,0,284269,1,d,584142,276981,307161,792390,245248,547142,538055,126099,411956,792390,161751,150103,152722,106306,295726,181344,70795,43587,-12,10,12,-2,-10,-8,14,-4,-7,-22,72,-6,4
2016,LA,3,56215,220621,282443,0,r,578354,277375,300979,785686,550599,235087,514979,108186,406793,785686,137593,146418,149866,106988,289330,157754,76143,55433,-12,10,12,-2,-10,-8,14,-4,-7,-22,70,-6,3
2016,LA,4,46579,216540,268761,0,r,558670,272412,286258,753181,453897,299284,497252,98863,398389,753181,133473,136098,141153,116905,279395,167651,69695,42049,-12,10,12,-2,-10,-8,14,-4,-7,-22,72,-6,3
2016,LA,5,0,255662,255662,1,r,564371,278263,286108,748306,465878,282428,496174,83219,412955,748306,127796,140677,141261,117642,265342,163082,65084,37176,-12,10,12,-2,-10,-8,14,-4,-7,-22,74,-6,3
2016,LA,6,79202,241075,331098,1,r,589185,278738,310447,798676,557762,240914,523041,146070,376971,798676,159923,151563,146646,103061,289146,125036,84893,79217,-12,10,12,-2,-10,-8,14,-4,-7,-22,68,-6,3
2016,MA,1,235803,0,349676,1,d,562553,265816,296737,729294,628922,100372,503362,149632,353730,729294,123223,129988,154869,128109,285949,130353,83588,72008,-12,10,12,-2,-10,-8,14,-4,-7,-22,46,-6,4
2016,MA,2,275487,0,363197,1,d,558018,270745,287273,749202,619606,129596,500935,192289,308646,749202,125478,143165,155113,111049,279000,111341,78264,89395,-12,10,12,-2,-10,-8,14,-4,-7,-22,46,-6,5
2016,MA,3,236713,107519,360124,1,d,531874,256781,275093,761611,603805,157806,515641,192950,322691,761611,128681,152135,163424,103694,270620,93746,71871,105003,-12,10,12,-2,-10,-8,14,-4,-7,-22,40,-6,5
2016,MA,4,265823,113055,395304,1,d,551896,266442,285454,753156,646441,106715,512380,261437,250943,753156,108982,148862,161380,118510,271263,71762,65344,134157,-12,10,12,-2,-10,-8,14,-4,-7,-22,44,-6,5
2016,MA,5,285606,0,385455,1,d,523553,248972,274581,759165,583376,175789,536665,307838,228827,759165,140785,154235,152679,117605,292625,81007,75811,135807,-12,10,12,-2,-10,-8,14,-4,-7,-22,43,-6,6
2016,MA,6,308923,0,415749,0,d,567547,270396,297151,766310,648461,117849,539492,237246,302246,766310,116709,147637,169809,132242,289280,85160,83494,120626,-12,10,12,-2,-10,-8,14,-4,-7,-22,45,-6,4
2016,MA,7,253354,0,309645,1,d,512263,239980,272283,779173,383951,395222,524484,225056,299428,779173,228107,143566,118259,81857,292430,125026,73792,93612,-12,10,12,-2,-10,-8,14,-4,-7,-22,55,-6,5
2016,MA,8,271019,102744,396009,1,d,568219,266574,301645,773806,584673,189133,558462,261548,296914,773806,156755,151577,154847,124727,302523,96617,80671,125235,-12,10,12,-2,-10,-8,14,-4,-7,-22,51,-6,4
2016,MA,9,211790,127803,403642,1,d,572118,269918,302200,740062,650940,89122,536094,192350,343744,740062,105862,135574,165012,156632,295708,109732,89341,96635,-12,10,12,-2,-10,-8,14,-4,-7,-22,48,-6,4
2016,MD,1,103622,242574,362097,1,r,560337,268999,291338,735590,600511,135079,510595,156013,354582,735590,107911,136852,160944,131366,272561,101207,81428,89926,-12,10,12,-2,-10,-8,14,-4,-7,-22,63,-6,4
2016,MD,2,192183,102577,309480,1,d,543046,255277,287769,764948,421691,343257,515885,172185,343700,764948,151707,147696,142526,104522,281015,100266,93601,87148,-12,10,12,-2,-10,-8,14,-4,-7,-22,65,-6,4
2016,MD,3,214640,115048,339675,1,d,557794,264540,293254,764166,480300,283866,531408,250593,280815,764166,152823,149313,155033,110278,292373,83850,86046,122477,-12,10,12,-2,-10,-8,14,-4,-7,-22,58,-6,5
2016,MD,4,237501,68670,320650,0,d,491160,225526,265634,755108,230153,524955,512319,174200,338119,755108,145483,156547,147145,95709,264065,74712,89748,99605,-12,10,12,-2,-10,-8,14,-4,-7,-22,66,-6,4
2016,MD,5,242989,105931,360634,1,d,551724,265528,286196,758857,371890,386967,510105,171919,338186,758857,126551,152872,159255,100615,261844,61885,76512,123447,-12,10,12,-2,-10,-8,14,-4,-7,-22,67,-6,5
2016,MD,6,185770,133081,331973,1,d,518306,252281,266025,757889,526311,231578,514750,213510,301240,757889,129790,154104,155106,107677,270725,88060,79476,103189,-12,10,12,-2,-10,-8,14,-4,-7,-22,50,-6,6
2016,MD,7,238838,69556,318912,1,d,532076,246501,285575,722745,259420,463325,498113,188388,309725,722745,140431,136578,146019,106210,270269,112433,74295,83541,-12,10,12,-2,-10,-8,14,-4,-7,-22,69,-6,5
2016,MD,8,220657,124651,364324,0,d,505650,242362,263288,757144,506979,250165,529333,294321,235012,757144,119590,158879,154901,120071,281805,67163,75139,139503,-12,10,12,-2,-10,-8,14,-4,-7,-22,49,-6,6
2016,ME,1,227546,164569,406942,1,d,536322,257248,279074,676165,636468,39697,493039,182132,310907,676165,104608,129157,153894,128318,276441,113637,90772,72032,-12,10,12,-2,-10,-8,14,-4,-7,-22,49,-6,4
2016,ME,2,159081,192878,364886,1,r,520569,254648,265921,655314,620652,34662,473530,109006,364524,655314,93460,118302,151111,128334,255219,135036,79434,40749,-12,10,12,-2,-10,-8,14,-4,-7,-22,51,-6,3
2016,MI,1,144334,197777,360271,0,r,561716,284050,277666,699621,645443,54178,507908,124895,383013,699621,97325,118758,160369,155837,283981,150001,89271,44709,-12,10,12,-2,-10,-8,14,-4,-7,-22,52,-6,4
2016,MI,10,110112,215132,340983,0,r,550305,269950,280355,714802,665867,48935,505568,116293,389275,714802,102826,138507,164111,125135,282229,116836,91829,73564,-12,10,12,-2,-10,-8,14,-4,-7,-22,50,-6,3
2016,MI,11,152461,200872,379488,0,r,531245,255885,275360,732690,601872,130818,512619,239134,273485,732690,114111,147347,163191,114700,285826,90176,82136,113514,-12,10,12,-2,-10,-8,14,-4,-7,-22,46,-6,4
2016,MI,12,211378,96104,328542,1,d,520539,249106,271433,708880,557103,151777,457354,155323,302031,708880,140627,125547,133271,98204,275304,123823,85172,66309,-12,10,12,-2,-10,-8,14,-4,-7,-22,55,-6,5
2016,MI,13,198771,40541,257797,0,d,475285,219016,256269,658383,248084,410299,433319,63838,369481,658383,122426,119365,133418,87282,259120,169569,63891,25660,-12,10,12,-2,-10,-8,14,-4,-7,-22,71,-6,4
2016,MI,14,244135,58103,310974,0,d,509210,237871,271339,701353,234356,466997,472803,145774,327029,701353,128837,133606,134850,108186,276252,153302,70472,52478,-12,10,12,-2,-10,-8,14,-4,-7,-22,70,-6,5
2016,MI,2,110391,212508,339328,1,r,537108,260119,276989,734965,622641,112324,478389,113989,364400,734965,131189,131492,141625,110046,272671,126209,93933,52529,-12,10,12,-2,-10,-8,14,-4,-7,-22,51,-6,3
2016,MI,3,128400,203545,342365,1,r,535983,264623,271360,733618,617675,115943,491063,154256,336807,733618,128575,137352,146487,104221,274579,120477,89803,64299,-12,10,12,-2,-10,-8,14,-4,-7,-22,56,-6,3
2016,MI,4,101277,194572,315751,0,r,550072,273249,276823,700487,657934,42553,477437,104341,373096,700487,107959,122199,148659,127229,269712,138587,84533,46592,-12,10,12,-2,-10,-8,14,-4,-7,-22,50,-6,4
2016,MI,5,195279,112102,319291,1,d,523601,248874,274727,681278,526471,154807,469947,89094,380853,681278,112140,123520,144209,120647,282014,162261,79825,39928,-12,10,12,-2,-10,-8,14,-4,-7,-22,67,-6,3
2016,MI,6,119980,193259,329565,1,r,537104,261305,275799,716163,604729,111434,476831,133293,343538,716163,123202,128216,144823,117343,278608,134149,89519,54940,-12,10,12,-2,-10,-8,14,-4,-7,-22,58,-6,4
2016,MI,7,134010,184321,334807,1,r,537643,267794,269849,700983,637876,63107,485550,119675,365875,700983,103820,132775,154456,119200,269633,118892,89420,61321,-12,10,12,-2,-10,-8,14,-4,-7,-22,54,-6,3
2016,MI,8,143791,205629,366968,1,r,544708,265639,279069,734008,624088,109920,478583,194355,284228,734008,120718,138724,149412,104196,277822,103947,84071,89804,-12,10,12,-2,-10,-8,14,-4,-7,-22,50,-6,4
2016,MI,9,199661,128937,344775,1,d,539434,259160,280274,711069,549342,161727,513031,155570,357461,711069,141005,135426,151311,116839,296402,130657,93744,72001,-12,10,12,-2,-10,-8,14,-4,-7,-22,62,-6,3
2016,MN,1,169071,166524,335873,1,d,495446,242787,252659,672415,606853,65562,446966,124932,322034,672415,115864,118612,131837,112125,265527,110321,90587,64619,-12,10,12,-2,-10,-8,14,-4,-7,-22,45,-6,3
2016,MN,2,167315,173970,370515,0,r,502833,246312,256521,700264,591403,108861,465096,178844,286252,700264,111933,144845,143981,91703,259773,75087,85800,98886,-12,10,12,-2,-10,-8,14,-4,-7,-22,48,-6,3
2016,MN,3,169238,223075,393457,1,r,498434,238449,259985,709906,567960,141946,491823,241035,250788,709906,111485,141925,153795,104449,275827,77547,80045,118235,-12,10,12,-2,-10,-8,14,-4,-7,-22,51,-6,3
2016,MN,4,203299,121033,351945,1,d,497262,237730,259532,702162,493306,208856,466882,197152,269730,702162,136926,128696,134329,96850,267990,100226,82687,85077,-12,10,12,-2,-10,-8,14,-4,-7,-22,49,-6,4
2016,MN,5,249957,80660,361875,1,d,514562,253939,260623,708082,477182,230900,485830,216108,269722,708082,183226,135040,122047,84060,297273,127898,88490,80885,-12,10,12,-2,-10,-8,14,-4,-7,-22,57,-6,3
2016,MN,6,123010,235385,358930,1,r,510473,256109,254364,696720,632472,64248,455351,134121,321230,696720,110982,145408,139384,85240,251892,78809,85844,87239,-12,10,12,-2,-10,-8,14,-4,-7,-22,50,-6,2
2016,MN,7,173572,156944,330823,1,d,500208,249701,250507,668049,611864,56185,449539,98150,351389,668049,99730,113547,134815,126348,264577,124153,91314,49110,-12,10,12,-2,-10,-8,14,-4,-7,-22,43,-6,2
2016,MN,8,179097,177088,356971,1,d,517748,261300,256448,662354,615526,46828,463796,106642,357154,662354,95381,116092,145780,129560,265866,123883,86712,55271,-12,10,12,-2,-10,-8,14,-4,-7,-22,50,-6,3
2016,MO,1,236993,62714,314024,1,d,552590,254146,298444,735410,318745,416665,499288,158707,340581,735410,159631,136532,141530,94801,308116,167030,88770,52316,-12,10,12,-2,-10,-8,14,-4,-7,-22,72,-6,5
2016,MO,2,155689,241954,413296,1,r,573945,272244,301701,763176,681910,81266,541082,266158,274924,763176,110382,145658,168741,140647,305616,94310,92672,118634,-12,10,12,-2,-10,-8,14,-4,-7,-22,49,-6,4
2016,MO,3,102891,249865,368333,1,r,590654,291613,299041,783679,725198,58481,527880,139369,388511,783679,123042,150655,160277,118936,286456,114112,100510,71834,-12,10,12,-2,-10,-8,14,-4,-7,-22,58,-6,3
2016,MO,4,92510,225348,332234,1,r,577806,287144,290662,761860,677392,84468,495113,118495,376618,761860,131892,132394,141805,123591,283792,146959,91465,45368,-12,10,12,-2,-10,-8,14,-4,-7,-22,56,-6,4
2016,MO,5,190766,123771,324270,1,d,563074,266969,296105,763288,522123,241165,519729,146615,373114,763288,145462,142347,148025,112870,313859,159981,99978,53900,-12,10,12,-2,-10,-8,14,-4,-7,-22,63,-6,3
2016,MO,6,99692,238388,350444,1,r,576624,284640,291984,767878,694426,73452,516860,148065,368795,767878,118402,149452,152715,121945,284610,122950,94867,66793,-12,10,12,-2,-10,-8,14,-4,-7,-22,54,-6,3
2016,MO,7,92756,228692,338607,1,r,582637,281589,301048,776586,712301,64285,513406,118900,394506,776586,133106,139203,146051,130894,305390,168367,94349,42674,-12,10,12,-2,-10,-8,14,-4,-7,-22,46,-6,3
2016,MO,8,70009,229792,308871,0,r,567657,281429,286228,741123,679412,61711,507656,76341,431315,741123,109663,137068,152001,133295,284351,166370,82398,35583,-12,10,12,-2,-10,-8,14,-4,-7,-22,62,-6,4
2016,MS,1,83947,206455,300423,0,r,574835,271549,303286,764223,524228,239995,501733,104029,397704,764223,119865,146957,144485,118073,280350,154975,82643,42732,-12,10,12,-2,-10,-8,14,-4,-7,-22,73,-6,3
2016,MS,2,192343,83542,286626,1,d,523733,245629,278104,705911,217330,488581,456953,88068,368885,705911,119657,128703,132484,103517,257899,166663,60852,30384,-12,10,12,-2,-10,-8,14,-4,-7,-22,76,-6,4
2016,MS,3,96101,209490,316445,1,r,561337,266025,295312,751004,457221,293783,492266,127452,364814,751004,122818,141459,143368,113381,271623,146118,72032,53473,-12,10,12,-2,-10,-8,14,-4,-7,-22,73,-6,4
2016,MS,4,77505,181323,278779,1,r,573219,275606,297613,767588,549955,217633,506070,106714,399356,767588,131528,145198,146120,114663,281373,151235,87200,42938,-12,10,12,-2,-10,-8,14,-4,-7,-22,69,-6,4
2016,MT,1,205919,285358,507831,0,r,804235,401606,402629,1042520,927374,115146,712616,220606,492010,1042520,172278,184184,217714,183881,416125,207949,128384,79792,-12,10,12,-2,-10,-8,14,-4,-7,-22,41,-6,3
2016,NC,1,240661,101567,350699,1,d,556875,256458,300417,750278,351832,398446,506769,140607,366162,750278,135950,139665,145824,118555,294949,171258,79419,44272,-12,10,12,-2,-10,-8,14,-4,-7,-22,69,-6,4
2016,NC,10,128919,220825,349744,1,r,580605,278228,302377,759453,614796,144657,534684,131649,403035,759453,118137,149865,160049,134831,297132,158304,91774,47054,-12,10,12,-2,-10,-8,14,-4,-7,-22,60,-6,3
2016,NC,11,129103,230405,359508,1,r,585515,276487,309028,749597,678534,71063,544373,130538,413835,749597,104373,136109,160810,165614,305113,170848,92726,41539,-12,10,12,-2,-10,-8,14,-4,-7,-22,50,-6,4
2016,NC,12,234115,115185,349300,0,d,564418,264695,299723,849357,404846,444511,559723,222647,337076,849357,194648,183395,139969,81647,320462,135949,103152,81361,-12,10,12,-2,-10,-8,14,-4,-7,-22,62,-6,3
2016,NC,13,156049,199443,355492,0,r,562668,262257,300411,768213,537499,230714,519850,140125,379725,768213,124590,147992,153214,123250,296838,155255,86541,55042,-12,10,12,-2,-10,-8,14,-4,-7,-22,62,-6,3
2016,NC,2,169082,221485,390567,0,r,573776,275255,298521,819899,584858,235041,541334,196107,345227,819899,125211,177857,158714,105016,288715,111173,90512,87030,-12,10,12,-2,-10,-8,14,-4,-7,-22,62,-6,3
2016,NC,3,106170,217531,323701,1,r,570032,285166,284866,754350,548218,206132,494006,112622,381384,754350,143528,129099,142352,122511,285216,148153,89400,47663,-12,10,12,-2,-10,-8,14,-4,-7,-22,64,-6,4
2016,NC,4,279380,130161,409541,1,d,595782,281601,314181,847032,524537,322495,560830,305383,255447,847032,180594,180009,152379,89410,321545,111804,105719,104022,-12,10,12,-2,-10,-8,14,-4,-7,-22,57,-6,4
2016,NC,5,147887,207625,355512,1,r,563839,269193,294646,751232,593578,157654,512473,134941,377532,751232,115388,142137,154353,129890,299083,163615,89302,46166,-12,10,12,-2,-10,-8,14,-4,-7,-22,59,-6,3
2016,NC,6,143167,207983,351150,1,r,558550,264308,294242,763491,545204,218287,528196,130077,398119,763491,106658,152053,161057,129637,297993,155126,89327,53540,-12,10,12,-2,-10,-8,14,-4,-7,-22,62,-6,3
2016,NC,7,135905,211801,347706,1,r,592197,283162,309035,780442,585311,195131,545645,135767,409878,780442,119959,147384,161672,146812,308011,165139,92258,50614,-12,10,12,-2,-10,-8,14,-4,-7,-22,63,-6,3
2016,NC,8,133182,189863,323045,1,r,562414,271402,291012,774967,509184,265783,512925,135953,376972,774967,141379,147411,141376,114273,288388,142257,93002,53129,-12,10,12,-2,-10,-8,14,-4,-7,-22,63,-6,3
2016,NC,9,139041,193452,332493,1,r,551456,260865,290591,778477,510668,267809,516377,174689,341688,778477,110546,164186,158365,107145,278978,126386,78617,73975,-12,10,12,-2,-10,-8,14,-4,-7,-22,62,-6,3
2016,ND,1,80377,233980,338459,1,r,570697,292569,278128,757953,660919,97034,495015,146323,348692,757953,157157,129913,139193,109851,315134,128956,103997,82181,-12,10,12,-2,-10,-8,14,-4,-7,-22,49,-6,2
2016,NE,1,83467,189771,273238,1,r,460328,227698,232630,639048,569839,69209,408833,132732,276101,639048,120591,112113,116013,94903,250655,110374,81480,58801,-12,10,12,-2,-10,-8,14,-4,-7,-22,45,-6,3
2016,NE,2,137602,141066,288308,0,d,452663,219258,233405,661142,541346,119796,429593,168252,261341,661142,125061,130695,118997,78589,252290,101799,77981,72510,-12,10,12,-2,-10,-8,14,-4,-7,-22,52,-6,3
2016,NE,3,0,226720,226720,1,r,441466,218375,223091,606926,563678,43248,405394,89988,315406,606926,88509,104777,120548,111798,244617,119770,80690,44157,-12,10,12,-2,-10,-8,14,-4,-7,-22,40,-6,3
2016,NH,1,162080,157176,365984,0,r,525955,259406,266549,671625,627367,44258,474973,176891,298082,671625,111631,129740,154491,107514,264517,87051,89504,87962,-12,10,12,-2,-10,-8,14,-4,-7,-22,43,-6,3
2016,NH,2,174371,158825,350509,1,d,517925,253590,264335,663170,619788,43382,472613,169787,302826,663170,98705,123876,151951,119418,256126,90271,83361,82494,-12,10,12,-2,-10,-8,14,-4,-7,-22,43,-6,4
2016,NJ,1,183231,112388,305473,0,d,540707,255024,285683,731932,496612,235320,503534,153242,350292,731932,130772,142866,149056,111671,268934,100077,81533,87324,-12,10,12,-2,-10,-8,14,-4,-7,-22,55,-6,3
2016,NJ,10,190856,26450,222771,0,d,482258,228819,253439,758062,219967,538095,498612,141026,357586,758062,150598,155782,138926,87238,263874,131570,72288,60016,-12,10,12,-2,-10,-8,14,-4,-7,-22,62,-6,3
2016,NJ,11,130162,194299,334992,1,r,536705,256889,279816,733706,601372,132334,518617,282142,236475,733706,97648,149926,164398,129453,264000,55590,63763,144647,-12,10,12,-2,-10,-8,14,-4,-7,-22,39,-6,4
2016,NJ,12,181430,92407,288634,0,d,497727,236032,261695,760061,451489,308572,521981,237387,284594,760061,122051,154836,155261,115141,261895,80748,66609,114538,-12,10,12,-2,-10,-8,14,-4,-7,-22,47,-6,5
2016,NJ,2,110838,176338,297795,1,r,534062,260018,274044,725217,546696,178521,507133,130862,376271,725217,114054,135252,155291,129085,263281,112550,78028,72703,-12,10,12,-2,-10,-8,14,-4,-7,-22,51,-6,3
2016,NJ,3,127526,194596,328060,0,r,566131,273311,292820,739696,589354,150342,524793,177650,347143,739696,114983,138103,160012,141243,279855,92001,87751,100103,-12,10,12,-2,-10,-8,14,-4,-7,-22,55,-6,3
2016,NJ,4,111532,211992,332684,1,r,518180,245237,272943,732142,620052,112090,494097,195479,298618,732142,105240,132513,152463,132463,265981,87322,72319,106340,-12,10,12,-2,-10,-8,14,-4,-7,-22,49,-6,4
2016,NJ,5,172587,157690,337701,1,r,531106,256690,274416,742865,590674,152191,512908,244888,268020,742865,104644,148090,168323,119102,260235,62933,66787,130515,-12,10,12,-2,-10,-8,14,-4,-7,-22,42,-6,4
2016,NJ,6,167895,91908,263435,0,d,493206,244022,249184,750419,478266,272153,511902,198981,312921,750419,137592,154409,149588,100323,254143,81495,74563,98085,-12,10,12,-2,-10,-8,14,-4,-7,-22,42,-6,4
2016,NJ,7,148188,185850,343635,1,r,517370,249980,267390,732070,577034,155036,511124,262327,248797,732070,99687,152971,170718,113057,264024,56181,64744,143099,-12,10,12,-2,-10,-8,14,-4,-7,-22,41,-6,4
2016,NJ,8,134733,32337,174889,1,d,436722,210561,226161,778294,446678,331616,541714,179350,362364,778294,191892,175612,132026,81046,283931,124821,77694,81416,-12,10,12,-2,-10,-8,14,-4,-7,-22,41,-6,4
2016,NJ,9,162642,65376,233242,0,d,473371,225253,248118,760005,472714,287291,524757,176468,348289,760005,137688,158277,147248,112333,264366,106312,68870,89184,-12,10,12,-2,-10,-8,14,-4,-7,-22,42,-6,3
2016,NM,1,181088,96879,277967,1,d,510269,245256,265013,702719,501221,201498,484169,159280,324889,702719,130032,130912,139121,111923,271742,136534,80442,54766,-12,10,12,-2,-10,-8,14,-4,-7,-22,37,-6,5
2016,NM,2,85232,143515,228817,0,r,471929,236203,235726,691695,589953,101742,447515,93921,353594,691695,120204,118859,126216,114286,240631,138525,68029,34077,-12,10,12,-2,-10,-8,14,-4,-7,-22,36,-6,4
2016,NM,3,170612,102730,273342,1,d,499660,242939,256721,686601,448460,238141,459697,125032,334665,686601,109583,124374,132858,115852,245991,124702,71463,49826,-12,10,12,-2,-10,-8,14,-4,-7,-22,36,-6,5
2016,NV,1,116537,54174,188352,1,d,423110,217813,205297,722331,383045,339286,482624,73527,409097,722331,143870,145939,131333,94808,251845,153397,70004,28444,-12,10,12,-2,-10,-8,14,-4,-7,-22,42,-6,2
2016,NV,2,115722,182676,313336,1,r,511199,258230,252969,713779,577546,136233,492221,125358,366863,713779,122503,131035,146542,118415,271213,116334,87323,67556,-12,10,12,-2,-10,-8,14,-4,-7,-22,37,-6,4
2016,NV,3,146869,142926,310963,0,r,557999,276420,281579,779908,530453,249455,554297,174520,379777,779908,144068,164285,146711,124234,287760,102120,101227,84413,-12,10,12,-2,-10,-8,14,-4,-7,-22,42,-6,3
2016,NV,4,128985,118328,265846,1,r,484115,235867,248248,724040,475646,248394,481468,98370,383098,724040,128945,144633,134063,104304,244340,108833,81539,53968,-12,10,12,-2,-10,-8,14,-4,-7,-22,48,-6,3
2016,NY,1,126635,158409,341554,1,r,525021,255957,269064,718175,623731,94444,496437,169487,326950,718175,105257,142008,152530,124876,237708,64381,66393,106934,-12,10,12,-2,-10,-8,14,-4,-7,-22,44,-6,5
2016,NY,10,180117,46275,266516,1,d,467979,224650,243329,708960,497928,211032,510231,307474,202757,708960,162269,150660,122685,105578,302765,103652,61746,137367,-12,10,12,-2,-10,-8,14,-4,-7,-22,37,-6,5
2016,NY,11,85257,122606,251718,0,r,502718,237713,265005,735452,515460,219992,511976,176369,335607,735452,135004,146243,146518,114400,257947,97438,68167,92342,-12,10,12,-2,-10,-8,14,-4,-7,-22,42,-6,4
2016,NY,12,230153,49398,312289,1,d,537560,246088,291472,715471,525079,190392,568765,410467,158298,715471,233444,149081,114661,104203,358652,98202,80178,180272,-12,10,12,-2,-10,-8,14,-4,-7,-22,40,-6,5
2016,NY,13,207194,13129,255239,0,d,496623,232107,264516,812752,232672,580080,562833,174347,388486,812752,212820,162134,138307,96905,292811,162962,78237,51612,-12,10,12,-2,-10,-8,14,-4,-7,-22,50,-6,4
2016,NY,14,138367,26891,197301,1,d,389836,188187,201649,691715,314005,377710,492785,126136,366649,691715,140636,158084,123167,95760,234113,108480,73401,52232,-12,10,12,-2,-10,-8,14,-4,-7,-22,40,-6,3
2016,NY,15,165688,6129,193703,1,d,402324,176507,225817,768801,118476,650325,459976,57193,402783,768801,168172,141054,122749,70932,253527,179256,53312,20959,-12,10,12,-2,-10,-8,14,-4,-7,-22,49,-6,2
2016,NY,16,198811,0,287556,1,d,496245,224644,271601,736806,342847,393959,506311,205720,300591,736806,119062,148015,143616,126096,265359,102365,69170,93824,-12,10,12,-2,-10,-8,14,-4,-7,-22,57,-6,5
2016,NY,17,193819,0,325571,1,d,477944,227521,250423,744406,510069,234337,492159,218818,273341,744406,111943,144174,149728,114113,242934,68988,58065,115881,-12,10,12,-2,-10,-8,14,-4,-7,-22,46,-6,5
2016,NY,18,140951,111117,319123,1,d,520551,254116,266435,722617,552745,169872,482745,172459,310286,722617,111133,142575,153023,105647,247953,81580,66348,100025,-12,10,12,-2,-10,-8,14,-4,-7,-22,49,-6,5
2016,NY,19,125956,135905,326588,0,r,548927,273364,275563,698185,619777,78408,494345,144178,350167,698185,99831,125064,160746,133220,262401,112852,77935,71614,-12,10,12,-2,-10,-8,14,-4,-7,-22,50,-6,5
2016,NY,2,102270,157571,317552,1,r,504231,245490,258741,714040,528448,185592,492562,153729,338833,714040,123375,142134,158275,100449,217363,54070,61332,101961,-12,10,12,-2,-10,-8,14,-4,-7,-22,45,-6,4
2016,NY,20,188428,83328,332499,1,d,555300,267439,287861,723416,573867,149549,490842,190139,300703,723416,134505,132306,145515,116082,279485,111219,84840,83426,-12,10,12,-2,-10,-8,14,-4,-7,-22,54,-6,5
2016,NY,21,75965,152597,288611,1,r,557028,282181,274847,711798,654596,57202,492810,114368,378442,711798,121445,129535,151029,122471,277069,130462,90484,56123,-12,10,12,-2,-10,-8,14,-4,-7,-22,52,-6,5
2016,NY,22,102734,113287,296086,0,r,544952,267962,276990,703464,629055,74409,478015,124469,353546,703464,109989,123057,148875,125140,270214,126930,88971,54313,-12,10,12,-2,-10,-8,14,-4,-7,-22,53,-6,4
2016,NY,23,106600,136964,296198,1,r,543388,267167,276221,703717,636916,66801,473139,123438,349701,703717,110301,118602,148205,123471,272324,138757,84825,48742,-12,10,12,-2,-10,-8,14,-4,-7,-22,49,-6,5
2016,NY,24,110550,150330,315429,0,r,540253,259185,281068,707479,596076,111403,482795,146209,336586,707479,115223,128214,149909,115853,278410,124507,88141,65762,-12,10,12,-2,-10,-8,14,-4,-7,-22,58,-6,5
2016,NY,25,168660,113840,336386,1,d,545800,259072,286728,720963,544995,175968,493155,183938,309217,720963,131160,128332,145463,118502,288805,133238,86347,69220,-12,10,12,-2,-10,-8,14,-4,-7,-22,58,-6,4
2016,NY,26,195322,56930,310819,1,d,542113,252019,290094,709220,508727,200493,489631,150889,338742,709220,137866,122093,144887,117948,298589,155474,85420,57695,-12,10,12,-2,-10,-8,14,-4,-7,-22,61,-6,4
2016,NY,27,107832,175509,354426,1,r,566465,282204,284261,720133,669976,50157,513895,157696,356199,720133,110165,137333,162867,128964,285986,111985,98348,75653,-12,10,12,-2,-10,-8,14,-4,-7,-22,52,-6,5
2016,NY,3,171775,133954,350966,0,d,527345,251020,276325,732591,549318,183273,520941,269054,251887,732591,101453,136806,164168,144898,247036,55803,55290,135943,-12,10,12,-2,-10,-8,14,-4,-7,-22,37,-6,5
2016,NY,4,181861,111246,343179,1,d,502333,237460,264873,723377,468263,255114,492563,209267,283296,723377,116454,138895,146729,118905,230997,58018,57198,115781,-12,10,12,-2,-10,-8,14,-4,-7,-22,49,-6,5
2016,NY,5,197852,26791,249236,1,d,507957,235322,272635,794154,140669,653485,536759,137064,399695,794154,148662,157660,162561,103378,224668,86615,69985,68068,-12,10,12,-2,-10,-8,14,-4,-7,-22,59,-6,3
2016,NY,6,131463,43770,210378,1,d,448050,209280,238770,753744,329853,423891,556219,199438,356781,753744,148428,157151,161121,117845,266579,112069,79159,75351,-12,10,12,-2,-10,-8,14,-4,-7,-22,35,-6,4
2016,NY,7,165819,14941,206983,0,d,452670,213698,238972,763468,361054,402414,516819,174106,342713,763468,200392,154510,122884,78861,256169,119446,63546,73177,-12,10,12,-2,-10,-8,14,-4,-7,-22,41,-6,4
2016,NY,8,203235,0,257602,1,d,530777,236374,294403,771711,229400,542311,538705,181531,357174,771711,176254,148879,143617,107838,284949,137343,75495,72111,-12,10,12,-2,-10,-8,14,-4,-7,-22,64,-6,4
2016,NY,9,198886,0,256853,1,d,468070,207267,260803,738674,256461,482213,506179,189829,316350,738674,150261,150031,137542,98446,274241,126315,77200,70726,-12,10,12,-2,-10,-8,14,-4,-7,-22,64,-6,4
2016,OH,1,144644,210014,354788,1,r,540545,261466,279079,739216,520167,219049,487770,165022,322748,739216,127730,137280,146928,102823,289541,130908,86658,71975,-12,10,12,-2,-10,-8,14,-4,-7,-22,66,-6,4
2016,OH,10,109981,215724,336602,1,r,548128,260714,287414,720354,553044,167310,490922,137169,353753,720354,125047,127802,144406,122576,297509,148782,88063,60664,-12,10,12,-2,-10,-8,14,-4,-7,-22,67,-6,4
2016,OH,11,242917,59769,302686,1,d,526991,239389,287602,692226,272086,420140,471089,126403,344686,692226,126440,121540,140424,113556,298406,186041,68190,44175,-12,10,12,-2,-10,-8,14,-4,-7,-22,73,-6,5
2016,OH,12,112638,251266,377534,1,r,564263,273760,290503,758614,661114,97500,517910,212333,305577,758614,126717,154625,152187,114332,287747,105657,85438,96652,-12,10,12,-2,-10,-8,14,-4,-7,-22,52,-6,4
2016,OH,13,208610,99377,308004,1,d,551819,264178,287641,709683,587038,122645,493718,117167,376551,709683,125307,126392,148459,127760,298591,169334,89209,40048,-12,10,12,-2,-10,-8,14,-4,-7,-22,65,-6,3
2016,OH,14,130907,219191,350269,1,r,545895,263362,282533,710875,645356,65519,506150,172482,333668,710875,96271,130651,165019,135390,288659,112412,92976,83271,-12,10,12,-2,-10,-8,14,-4,-7,-22,56,-6,4
2016,OH,15,113960,222847,336807,1,r,570296,284689,285607,743623,672078,71545,510533,160537,349996,743623,137501,144729,148197,108094,280339,112612,94801,72926,-12,10,12,-2,-10,-8,14,-4,-7,-22,57,-6,3
2016,OH,16,119830,225794,345624,1,r,563346,273043,290303,727600,679041,48559,513497,170859,342638,727600,112229,132389,158122,136318,288286,108832,101201,78253,-12,10,12,-2,-10,-8,14,-4,-7,-22,51,-6,3
2016,OH,2,111694,221193,340279,1,r,553658,264169,289489,724451,631322,93129,504577,163161,341416,724451,125199,139020,149828,118114,297079,134967,88472,73640,-12,10,12,-2,-10,-8,14,-4,-7,-22,64,-6,4
2016,OH,3,199791,91560,291351,1,d,545540,260985,284555,787306,444180,343126,501080,139320,361760,787306,180456,149698,131660,76467,306114,163345,96423,46346,-12,10,12,-2,-10,-8,14,-4,-7,-22,67,-6,3
2016,OH,4,98981,210227,309208,1,r,544949,270983,273966,714115,641125,72990,483826,86479,397347,714115,114811,133497,148847,119739,274691,129031,94002,51658,-12,10,12,-2,-10,-8,14,-4,-7,-22,60,-6,3
2016,OH,5,100392,244599,344991,1,r,551422,269878,281544,720730,663424,57306,488833,127857,360976,720730,116231,129836,149616,121681,288645,125387,95802,67456,-12,10,12,-2,-10,-8,14,-4,-7,-22,48,-6,4
2016,OH,6,88780,213975,302755,1,r,551728,273625,278103,703190,668912,34278,495796,79003,416793,703190,102392,130100,156130,132922,276003,146741,88335,40927,-12,10,12,-2,-10,-8,14,-4,-7,-22,63,-6,3
2016,OH,7,89638,198221,309553,1,r,549994,266444,283550,728336,676090,52246,497371,103724,393647,728336,105120,133211,154974,129214,278042,128079,96107,53856,-12,10,12,-2,-10,-8,14,-4,-7,-22,61,-6,3
2016,OH,8,87794,223833,325506,0,r,544066,262282,281784,727853,645438,82415,482000,114956,367044,727853,115959,133757,147236,116335,276239,118675,93500,64064,-12,10,12,-2,-10,-8,14,-4,-7,-22,58,-6,3
2016,OH,9,193966,88427,282398,1,d,533345,254784,278561,706201,515806,190395,476989,103209,373780,706201,128590,129362,140344,109593,298778,171994,84928,41856,-12,10,12,-2,-10,-8,14,-4,-7,-22,60,-6,4
2016,OK,1,0,1,1,1,r,557020,263838,293182,796981,564445,232536,525844,158543,367301,796981,144868,151078,148681,112334,312495,148802,91959,71734,-12,10,12,-2,-10,-8,14,-4,-7,-22,52,-6,3
2016,OK,2,62387,189839,268870,1,r,562496,275508,286988,749490,497803,251687,504072,85703,418369,749490,118412,132008,146765,135419,275946,161676,79012,35258,-12,10,12,-2,-10,-8,14,-4,-7,-22,52,-6,3
2016,OK,3,63090,227525,290615,1,r,565593,282106,283487,779596,616508,163088,504253,115380,388873,779596,133896,139824,144009,120748,281394,144922,85710,50762,-12,10,12,-2,-10,-8,14,-4,-7,-22,46,-6,3
2016,OK,4,76472,204143,293189,1,r,579815,286938,292877,781940,595384,186556,506434,129212,377222,781940,144089,144088,144247,111481,290128,132224,100242,57662,-12,10,12,-2,-10,-8,14,-4,-7,-22,52,-6,3
2016,OK,5,103273,160184,280570,1,r,556914,264825,292089,815554,567327,248227,531033,159827,371206,815554,161311,150997,144875,108310,309379,155361,89487,64531,-12,10,12,-2,-10,-8,14,-4,-7,-22,53,-6,3
2016,OR,1,225391,139756,378095,1,d,583955,284695,299260,830772,660825,169947,576055,236514,339541,830772,154867,173954,159165,117950,311524,106749,98629,106146,-12,10,12,-2,-10,-8,14,-4,-7,-22,37,-6,4
2016,OR,2,106640,272952,380739,1,r,606124,301419,304705,809980,728420,81560,569454,135628,433826,809980,125629,142746,165604,161659,315374,158150,99126,58098,-12,10,12,-2,-10,-8,14,-4,-7,-22,38,-6,4
2016,OR,3,274687,0,382355,1,d,615237,299141,316096,835143,661685,173458,597707,246190,351517,835143,181653,188390,157306,106297,324260,128189,101383,94688,-12,10,12,-2,-10,-8,14,-4,-7,-22,44,-6,4
2016,OR,4,220628,157743,397568,1,d,621612,302489,319123,795499,708840,86659,554143,148164,405979,795499,137089,134043,159955,161830,318197,167772,95934,54491,-12,10,12,-2,-10,-8,14,-4,-7,-22,38,-6,4
2016,OR,5,199505,160443,373108,1,d,594558,289083,305475,822071,696040,126031,560593,168034,392559,822071,134393,152088,162778,141152,302323,124145,100261,77917,-12,10,12,-2,-10,-8,14,-4,-7,-22,37,-6,4
2016,PA,1,245791,53219,299010,1,d,506105,240958,265147,721901,335417,386484,487481,133607,353874,721901,171336,138452,127928,80660,260860,140714,72291,47855,-12,10,12,-2,-10,-8,14,-4,-7,-22,60,-6,4
2016,PA,10,89823,211282,301105,1,r,539878,268803,271075,689108,637125,51983,486771,109424,377347,689108,96493,123999,150334,136388,256391,120911,84750,50730,-12,10,12,-2,-10,-8,14,-4,-7,-22,52,-6,4
2016,PA,11,113800,199421,313221,1,r,549295,268485,280810,707150,628731,78419,499554,125218,374336,707150,107665,130264,155227,129133,278092,128255,91863,57974,-12,10,12,-2,-10,-8,14,-4,-7,-22,52,-6,3
2016,PA,12,137353,221851,359204,1,r,548829,266005,282824,697773,645157,52616,508812,171679,337133,697773,99547,128520,159325,142667,283824,117526,88851,77447,-12,10,12,-2,-10,-8,14,-4,-7,-22,55,-6,4
2016,PA,13,239316,0,239316,1,d,505546,233771,271775,731754,453831,277923,500542,176996,323546,731754,137585,138269,140703,114690,268338,115173,80507,72658,-12,10,12,-2,-10,-8,14,-4,-7,-22,55,-6,4
2016,PA,14,255293,87999,343292,1,d,559100,264905,294195,696529,500892,195637,499614,176959,322655,696529,158727,114436,142559,119420,317371,171703,91050,54618,-12,10,12,-2,-10,-8,14,-4,-7,-22,68,-6,4
2016,PA,15,124129,190618,326474,1,r,548475,267367,281108,725473,611339,114134,499561,146066,353495,725473,115680,137102,147351,125906,275165,107718,91578,75869,-12,10,12,-2,-10,-8,14,-4,-7,-22,45,-6,4
2016,PA,16,134586,168669,313773,0,r,523888,253052,270836,725915,603670,122245,480362,120704,359658,725915,124314,132003,138210,116138,261448,110930,88780,61738,-12,10,12,-2,-10,-8,14,-4,-7,-22,48,-6,3
2016,PA,17,157734,135430,293164,1,d,546023,267546,278477,699918,613333,86585,494796,112440,382356,699918,113473,128437,150969,128752,270356,129503,86954,53899,-12,10,12,-2,-10,-8,14,-4,-7,-22,51,-6,3
2016,PA,18,0,293684,293684,1,r,554967,268952,286015,707100,657727,49373,515746,188077,327669,707100,100920,134678,156544,142381,286700,111729,90386,84585,-12,10,12,-2,-10,-8,14,-4,-7,-22,53,-6,3
2016,PA,2,322514,35131,357645,0,d,536982,235204,301778,711404,225072,486332,478445,175760,302685,711404,170632,120047,125747,100164,279336,156979,65324,57033,-12,10,12,-2,-10,-8,14,-4,-7,-22,69,-6,5
2016,PA,3,0,244893,244893,1,r,544370,265322,279048,693850,637132,56718,491606,130385,361221,693850,106623,124372,154474,129774,278846,134889,87944,56013,-12,10,12,-2,-10,-8,14,-4,-7,-22,60,-6,4
2016,PA,4,113372,220628,334000,1,r,551920,266067,285853,726738,615250,111488,506749,135373,371376,726738,117276,138386,152677,123726,281239,112747,97628,70864,-12,10,12,-2,-10,-8,14,-4,-7,-22,55,-6,3
2016,PA,5,101082,206761,307843,1,r,554919,284765,270154,700472,654366,46106,478792,120230,358562,700472,108805,123945,145261,126626,263672,135603,80636,47433,-12,10,12,-2,-10,-8,14,-4,-7,-22,53,-6,4
2016,PA,6,155000,207469,362469,0,r,551662,267147,284515,737397,636242,101155,506336,218810,287526,737397,117069,140099,159944,116294,274134,82482,81431,110221,-12,10,12,-2,-10,-8,14,-4,-7,-22,46,-6,4
2016,PA,7,153824,225678,379502,1,r,536290,259826,276464,712330,613745,98585,494979,215057,279922,712330,99332,135865,153978,128106,258813,73791,72795,112227,-12,10,12,-2,-10,-8,14,-4,-7,-22,52,-6,4
2016,PA,8,173555,207263,380818,0,r,536207,260749,275458,709746,622195,87551,504804,200545,304259,709746,102981,137242,163693,125883,265416,79156,82533,103727,-12,10,12,-2,-10,-8,14,-4,-7,-22,46,-6,4
2016,PA,9,107985,186580,294565,1,r,545665,265807,279858,689669,649653,40016,487025,90407,396618,689669,102493,124058,151064,135053,277770,144035,89261,44474,-12,10,12,-2,-10,-8,14,-4,-7,-22,58,-6,3
2016,RI,1,130534,71023,202371,1,d,386517,182935,203582,536871,409930,126941,369960,126529,243431,536871,97595,98443,111253,83280,205952,93477,58426,54049,-12,10,12,-2,-10,-8,14,-4,-7,-22,49,-6,4
2016,RI,2,133108,70301,229148,1,d,401428,189991,211437,519555,440175,79380,364085,123736,240349,519555,88123,97906,109595,90775,202287,83153,58285,60849,-12,10,12,-2,-10,-8,14,-4,-7,-22,43,-6,4
2016,SC,1,110539,190410,325170,1,r,574786,271715,303071,761869,575670,186199,532326,212198,320128,761869,136959,147210,144558,130349,290002,108091,97103,84808,-12,10,12,-2,-10,-8,14,-4,-7,-22,64,-6,4
2016,SC,2,105306,183746,304996,1,r,525854,250280,275574,703246,493859,209387,478199,159982,318217,703246,117216,138632,142404,106318,269439,116183,88661,64595,-12,10,12,-2,-10,-8,14,-4,-7,-22,67,-6,4
2016,SC,3,72933,196325,269540,1,r,517634,248293,269341,684619,528975,155644,463546,101923,361623,684619,109930,122655,136724,120585,258490,141732,74375,42383,-12,10,12,-2,-10,-8,14,-4,-7,-22,67,-6,3
2016,SC,4,91676,198648,295670,1,r,523983,247001,276982,716552,531230,185322,486060,149109,336951,716552,123573,139353,137444,112686,273239,131218,85516,56505,-12,10,12,-2,-10,-8,14,-4,-7,-22,61,-6,3
2016,SC,5,105772,161669,273006,1,r,529155,253121,276034,704256,479673,224583,480516,110729,369787,704256,108216,139725,143769,113234,267518,136520,80574,50424,-12,10,12,-2,-10,-8,14,-4,-7,-22,70,-6,3
2016,SC,6,177947,70099,253901,1,d,512866,248321,264545,680469,258967,421502,442432,86728,355704,680469,133858,116943,123168,104565,248721,161338,60718,26665,-12,10,12,-2,-10,-8,14,-4,-7,-22,73,-6,3
2016,SC,7,103454,176468,289463,1,r,547053,255865,291188,710108,474178,235930,505397,101837,403560,710108,102133,128741,150003,142410,270478,151836,79071,39571,-12,10,12,-2,-10,-8,14,-4,-7,-22,71,-6,3
2016,SD,1,132810,237163,369973,1,r,635373,315615,319758,865454,732939,132515,565894,163261,402633,865454,144797,149611,167177,137569,334003,152763,115072,66168,-12,10,12,-2,-10,-8,14,-4,-7,-22,46,-6,3
2016,TN,1,39024,198293,253025,1,r,556521,269981,286540,714504,671967,42537,506886,98418,408468,714504,105518,137103,151027,139339,283213,167822,80607,34784,-12,10,12,-2,-10,-8,14,-4,-7,-22,50,-6,4
2016,TN,2,68401,212455,280856,0,r,568645,271472,297173,740182,657955,82227,509667,157823,351844,740182,127473,139464,148602,128454,294685,145115,92707,56863,-12,10,12,-2,-10,-8,14,-4,-7,-22,58,-6,4
2016,TN,3,76727,176613,266006,1,r,563418,270700,292718,728254,620620,107634,515359,117170,398189,728254,117222,139946,153732,131364,285079,156456,79975,48648,-12,10,12,-2,-10,-8,14,-4,-7,-22,63,-6,3
2016,TN,4,89141,165796,254937,0,r,569815,276039,293776,767655,652091,115564,508174,114594,393580,767655,137050,150021,145254,111299,284054,140009,93608,50437,-12,10,12,-2,-10,-8,14,-4,-7,-22,58,-6,3
2016,TN,5,171111,102433,273544,1,d,545923,255238,290685,762535,515652,246883,522400,195913,326487,762535,179938,151774,137158,90124,311394,143787,98525,69082,-12,10,12,-2,-10,-8,14,-4,-7,-22,62,-6,4
2016,TN,6,61995,202234,284490,1,r,574302,277734,296568,761538,698934,62604,526408,115376,411032,761538,115726,145032,154316,134381,289792,142601,91036,56155,-12,10,12,-2,-10,-8,14,-4,-7,-22,54,-6,3
2016,TN,7,65226,200407,277513,1,r,557896,272614,285282,765730,646913,118817,506330,142145,364185,765730,123655,153220,147126,109747,273435,125420,81578,66437,-12,10,12,-2,-10,-8,14,-4,-7,-22,59,-6,3
2016,TN,8,70925,194386,282733,0,r,532344,253844,278500,706468,531337,175131,482503,133037,349466,706468,101779,136746,145541,121400,260950,120172,76012,64766,-12,10,12,-2,-10,-8,14,-4,-7,-22,68,-6,4
2016,TN,9,171631,41123,217957,1,d,499813,230310,269503,704328,182009,522319,449471,108379,341092,704328,147420,131552,128295,79147,273730,165909,74382,33439,-12,10,12,-2,-10,-8,14,-4,-7,-22,72,-6,4
2016,TX,1,62847,192434,260409,1,r,505010,244306,260704,717735,548138,169597,465848,97213,368635,717735,115233,128328,133722,115212,250547,137853,72853,39841,-12,10,12,-2,-10,-8,14,-4,-7,-22,56,-6,3
2016,TX,10,120170,179221,312600,1,r,545627,270743,274884,823296,605730,217566,547243,211863,335380,823296,149239,176081,148516,96990,289151,95690,87706,105755,-12,10,12,-2,-10,-8,14,-4,-7,-22,45,-6,3
2016,TX,11,0,201871,225548,1,r,527626,261324,266302,759136,671305,87831,485147,98732,386415,759136,139600,127628,134413,116557,264303,130496,75261,58546,-12,10,12,-2,-10,-8,14,-4,-7,-22,39,-6,2
2016,TX,12,76029,196482,283115,1,r,535618,257400,278218,770350,608659,161691,511560,153171,358389,770350,146159,152522,143857,97542,280567,108640,91382,80545,-12,10,12,-2,-10,-8,14,-4,-7,-22,46,-6,3
2016,TX,13,0,199050,221242,1,r,486149,243550,242599,707421,605427,101994,460575,93779,366796,707421,117939,129788,128221,107423,254848,126933,78390,49525,-12,10,12,-2,-10,-8,14,-4,-7,-22,42,-6,3
2016,TX,14,99054,160631,259685,1,r,520249,261670,258579,753147,545161,207986,499765,113567,386198,753147,132905,147523,148090,98771,271252,120222,72988,78042,-12,10,12,-2,-10,-8,14,-4,-7,-22,52,-6,3
2016,TX,15,101712,66877,177479,0,d,416573,201063,215510,776887,621756,155131,448723,88643,360080,776887,139124,143378,111171,88042,221925,127307,57803,36815,-12,10,12,-2,-10,-8,14,-4,-7,-22,35,-6,2
2016,TX,16,150228,0,175229,1,d,445766,224098,221668,735784,601497,134287,450945,107762,343183,735784,153228,132385,116876,88910,239593,133101,69585,36907,-12,10,12,-2,-10,-8,14,-4,-7,-22,37,-6,3
2016,TX,17,86603,149417,245728,1,r,530958,259722,271236,761922,569015,192907,469035,137797,331238,761922,161266,136092,122881,91687,278052,136445,80477,61130,-12,10,12,-2,-10,-8,14,-4,-7,-22,47,-6,4
2016,TX,18,150157,48306,204308,1,d,465989,227443,238546,787352,379834,407518,487572,109294,378278,787352,167522,160701,124102,73691,274686,155017,69033,50636,-12,10,12,-2,-10,-8,14,-4,-7,-22,54,-6,3
2016,TX,19,0,176314,203475,0,r,515759,256551,259208,734532,614355,120177,454004,101773,352231,734532,144190,129191,119922,99104,256558,132609,78796,45153,-12,10,12,-2,-10,-8,14,-4,-7,-22,41,-6,3
2016,TX,2,100231,168692,278236,1,r,504370,244174,260196,779662,519314,260348,519320,211921,307399,779662,161428,167100,140597,82371,287714,94168,87534,106012,-12,10,12,-2,-10,-8,14,-4,-7,-22,45,-6,3
2016,TX,20,149640,0,187669,1,d,516422,254020,262402,791141,654066,137075,494588,122271,372317,791141,172338,152319,124587,84930,254256,128610,79173,46473,-12,10,12,-2,-10,-8,14,-4,-7,-22,38,-6,3
2016,TX,21,129765,202967,356031,1,r,598502,291191,307311,804470,694123,110347,553738,249503,304235,804470,153563,157303,154863,125155,315308,112928,97614,104766,-12,10,12,-2,-10,-8,14,-4,-7,-22,39,-6,4
2016,TX,22,123679,181864,305543,1,r,546113,265972,280141,881407,532428,348979,564955,254623,310332,881407,142503,197249,161248,93708,284890,78294,80036,126560,-12,10,12,-2,-10,-8,14,-4,-7,-22,43,-6,4
2016,TX,23,107526,110577,228965,1,r,480832,240431,240401,772944,620655,152289,477607,103442,374165,772944,143852,147396,125523,96500,226789,110452,66607,49730,-12,10,12,-2,-10,-8,14,-4,-7,-22,37,-6,3
2016,TX,24,108389,154845,275635,1,r,499885,238043,261842,790319,495045,295274,543716,243297,300419,790319,172547,170866,148988,82859,310253,103366,99921,106966,-12,10,12,-2,-10,-8,14,-4,-7,-22,44,-6,3
2016,TX,25,117073,180988,310196,1,r,552128,270562,281566,762897,637706,125191,506581,188219,318362,762897,130408,153109,145469,106312,266033,97008,81744,87281,-12,10,12,-2,-10,-8,14,-4,-7,-22,46,-6,3
2016,TX,26,94507,211730,319080,1,r,564226,270701,293525,845376,662384,182992,537493,237826,299667,845376,140797,192311,153862,78934,282462,76390,81952,124120,-12,10,12,-2,-10,-8,14,-4,-7,-22,44,-6,3
2016,TX,27,88329,142251,230580,1,r,511768,245846,265922,736778,621318,115460,479223,97043,382180,736778,127234,134172,136951,111245,260365,121347,81552,57466,-12,10,12,-2,-10,-8,14,-4,-7,-22,39,-6,3
2016,TX,28,122086,57740,184442,1,d,405399,195340,210059,736150,647918,88232,430861,76212,354649,736150,125493,136916,112094,84286,212327,115913,59873,36541,-12,10,12,-2,-10,-8,14,-4,-7,-22,37,-6,3
2016,TX,29,95649,31646,131982,1,d,361542,177664,183878,765403,590819,174584,451687,46816,404871,765403,147256,151122,125827,60240,234493,135456,69562,29475,-12,10,12,-2,-10,-8,14,-4,-7,-22,40,-6,3
2016,TX,3,109420,193684,316467,1,r,543174,261391,281783,842800,580112,262688,551334,295081,256253,842800,135198,198492,158110,88780,304582,77674,91890,135018,-12,10,12,-2,-10,-8,14,-4,-7,-22,44,-6,3
2016,TX,30,170502,41518,218826,1,d,458009,211708,246301,749289,365296,383993,466717,95816,370901,749289,152628,144837,131606,76403,263998,143931,78558,41509,-12,10,12,-2,-10,-8,14,-4,-7,-22,57,-6,3
2016,TX,31,103852,166060,284588,1,r,572177,279595,292582,830908,627321,203587,533222,183007,350215,830908,156539,175277,136911,97899,280467,96776,95225,88466,-12,10,12,-2,-10,-8,14,-4,-7,-22,47,-6,3
2016,TX,32,0,162868,229171,1,r,477590,231310,246280,753715,518302,235413,502640,218111,284529,753715,157672,154703,138403,86366,286210,100551,86597,99062,-12,10,12,-2,-10,-8,14,-4,-7,-22,47,-6,4
2016,TX,33,93147,33222,126369,1,d,336142,160783,175359,764730,510928,253802,435724,40595,395129,764730,149267,148816,110464,60612,229843,142644,67946,19253,-12,10,12,-2,-10,-8,14,-4,-7,-22,43,-6,3
2016,TX,34,104638,62323,166961,1,d,425445,211350,214095,723156,667875,55281,430781,65021,365760,723156,124009,128607,110909,101280,210523,126681,57625,26217,-12,10,12,-2,-10,-8,14,-4,-7,-22,35,-6,3
2016,TX,35,124612,62384,197576,1,d,524681,258228,266453,822601,599752,222849,508479,103516,404963,822601,195226,158290,124960,76200,264053,134693,86335,43025,-12,10,12,-2,-10,-8,14,-4,-7,-22,41,-6,3
2016,TX,36,0,193675,218565,1,r,501056,244551,256505,732975,608708,124267,475596,92435,383161,732975,124140,138965,141054,100664,251784,110609,72656,68519,-12,10,12,-2,-10,-8,14,-4,-7,-22,45,-6,3
2016,TX,4,0,216643,246220,1,r,528297,255778,272519,735554,600780,134774,494545,109431,385114,735554,106957,141319,143926,124006,262678,122920,80189,59569,-12,10,12,-2,-10,-8,14,-4,-7,-22,53,-6,3
2016,TX,5,0,155469,192875,1,r,486675,238295,248380,764456,581587,182869,494927,104193,390734,764456,133309,153039,133579,101885,253878,125393,75458,53027,-12,10,12,-2,-10,-8,14,-4,-7,-22,49,-6,3
2016,TX,6,106667,159444,273296,1,r,519785,251160,268625,770255,506922,263333,494562,142185,352377,770255,145400,153482,143070,90744,263565,95340,92591,75634,-12,10,12,-2,-10,-8,14,-4,-7,-22,53,-6,3
2016,TX,7,111991,143542,255533,1,r,449654,214099,235555,770606,518515,252091,518453,262762,255691,770606,165794,162519,137823,83417,303045,107942,83871,111232,-12,10,12,-2,-10,-8,14,-4,-7,-22,44,-6,4
2016,TX,8,0,236379,236379,1,r,554452,278407,276045,813519,675178,138341,534784,161259,373525,813519,137384,164344,156263,108908,276789,106614,82313,87862,-12,10,12,-2,-10,-8,14,-4,-7,-22,46,-6,3
2016,TX,9,152032,36491,188523,1,d,427912,201367,226545,793923,294780,499143,493330,117508,375822,793923,177231,152991,132810,75210,267825,143712,82762,41351,-12,10,12,-2,-10,-8,14,-4,-7,-22,52,-6,3
2016,UT,1,73380,182925,277451,1,r,495563,246888,248675,757558,679259,78299,434936,125692,309244,757558,141456,142225,115214,74198,234783,83907,87611,63265,-12,10,12,-2,-10,-8,14,-4,-7,-22,38,-6,3
2016,UT,2,93778,170524,276819,1,r,502385,253482,248903,749217,619637,129580,467152,151886,315266,749217,149394,138957,115941,98320,247006,100455,87829,58722,-12,10,12,-2,-10,-8,14,-4,-7,-22,38,-6,4
2016,UT,3,75716,209589,285305,1,r,491817,243294,248523,751776,686210,65566,409080,170231,238849,751776,161427,126309,105435,74022,219529,73626,72134,73769,-12,10,12,-2,-10,-8,14,-4,-7,-22,36,-6,3
2016,UT,4,113413,147597,274569,1,r,493609,245339,248270,792666,648177,144489,472076,133126,338950,792666,157518,158960,112677,72950,241829,80887,93221,67721,-12,10,12,-2,-10,-8,14,-4,-7,-22,37,-6,3
2016,VA,1,140785,230213,384601,1,r,564338,279578,284760,776836,559406,217430,523683,196328,327355,776836,122249,156792,157978,116169,277101,82907,82769,111425,-12,10,12,-2,-10,-8,14,-4,-7,-22,58,-6,4
2016,VA,10,187712,210791,400083,0,r,538250,265207,273043,827279,595156,232123,540873,293866,247007,827279,119387,188915,163589,95522,272000,49841,61444,160715,-12,10,12,-2,-10,-8,14,-4,-7,-22,42,-6,5
2016,VA,11,247818,0,282003,1,d,498639,245111,253528,802910,452742,350168,535531,297106,238425,802910,142895,179354,154634,91674,271313,53152,72037,146124,-12,10,12,-2,-10,-8,14,-4,-7,-22,45,-6,5
2016,VA,2,119440,190475,310567,0,r,557130,273809,283321,745816,501282,244534,497550,171357,326193,745816,153868,138722,138628,104634,271729,97649,92508,81572,-12,10,12,-2,-10,-8,14,-4,-7,-22,60,-6,4
2016,VA,3,208337,103289,312340,1,d,559055,264115,294940,739169,333518,405651,484767,126895,357872,739169,163709,130917,136685,96225,281520,134968,89579,56973,-12,10,12,-2,-10,-8,14,-4,-7,-22,70,-6,4
2016,VA,4,200136,145731,346656,0,r,586770,281424,305346,764301,398787,365514,525171,158240,366931,764301,149937,145039,157262,105133,286585,131124,88679,66782,-12,10,12,-2,-10,-8,14,-4,-7,-22,70,-6,4
2016,VA,5,148339,207758,356756,0,r,571889,275993,295896,735178,547945,187233,515301,143994,371307,735178,112821,130587,157557,141556,283654,134829,87993,60832,-12,10,12,-2,-10,-8,14,-4,-7,-22,67,-6,5
2016,VA,6,112170,225471,338409,1,r,581622,274895,306727,754859,628429,126430,506994,135038,371956,754859,120073,134745,150423,135066,293613,146627,90852,56134,-12,10,12,-2,-10,-8,14,-4,-7,-22,61,-6,4
2016,VA,7,160159,218057,379163,0,r,560961,267813,293148,775369,555523,219846,532431,207444,324987,775369,120720,162159,156700,118621,286841,93796,98158,94887,-12,10,12,-2,-10,-8,14,-4,-7,-22,59,-6,4
2016,VA,8,246653,98387,360676,1,d,508509,247549,260960,783079,492598,290481,562355,347325,215030,783079,184616,181129,140724,86155,314900,70654,84620,159626,-12,10,12,-2,-10,-8,14,-4,-7,-22,47,-6,6
2016,VA,9,87877,212838,310314,1,r,566616,281415,285201,707012,641649,65363,496517,101092,395425,707012,97734,128784,149475,137290,281436,160972,82265,38199,-12,10,12,-2,-10,-8,14,-4,-7,-22,60,-6,4
2016,VT,1,264414,0,320467,1,d,494736,242185,252551,624594,589379,35215,439563,159855,279708,624594,96305,113881,140197,113600,254851,110810,82203,61838,-12,10,12,-2,-10,-8,14,-4,-7,-22,46,-6,4
2016,WA,1,193619,155779,349398,1,d,506000,250132,255868,738149,579779,158370,512260,222087,290173,738149,128837,157228,150396,98715,270730,68540,79849,122341,-12,10,12,-2,-10,-8,14,-4,-7,-22,37,-6,3
2016,WA,10,170460,120104,290564,1,d,533610,264054,269556,732052,536286,195766,491669,140890,350779,732052,148183,138328,136576,102338,271628,105457,98151,68020,-12,10,12,-2,-10,-8,14,-4,-7,-22,46,-6,3
2016,WA,2,208314,117094,325408,1,d,534629,269381,265248,728550,557294,171256,502673,152278,350395,728550,139978,139060,143884,114440,278780,107037,91749,79994,-12,10,12,-2,-10,-8,14,-4,-7,-22,40,-6,3
2016,WA,3,119820,193457,313277,1,r,525262,257997,267265,722277,624307,97970,494070,125650,368420,722277,112693,137088,145942,122987,267226,108641,88739,69846,-12,10,12,-2,-10,-8,14,-4,-7,-22,40,-6,3
2016,WA,4,0,229919,229919,1,r,430064,214880,215184,715254,529482,185772,443185,89165,354020,715254,120110,127146,124693,96882,239010,111319,77056,50635,-12,10,12,-2,-10,-8,14,-4,-7,-22,36,-6,4
2016,WA,5,130575,192959,323534,1,r,536702,264290,272412,708228,618474,89754,474133,143983,330150,708228,127978,123038,138544,114862,274826,132263,88389,54174,-12,10,12,-2,-10,-8,14,-4,-7,-22,43,-6,4
2016,WA,6,201718,126116,327834,1,d,538702,269828,268874,699178,561148,138030,499615,148464,351151,699178,123694,122541,147889,134532,278664,114200,94455,70009,-12,10,12,-2,-10,-8,14,-4,-7,-22,46,-6,3
2016,WA,7,378754,0,378754,0,d,580064,286749,293315,766221,558071,208150,567356,346151,221205,766221,203534,158729,143999,103010,344997,107396,91120,146481,-12,10,12,-2,-10,-8,14,-4,-7,-22,40,-6,4
2016,WA,8,127720,193145,320865,1,r,505530,248198,257332,738218,577876,160342,490032,169166,320866,738218,113054,159384,150165,92200,261473,79820,80624,101029,-12,10,12,-2,-10,-8,14,-4,-7,-22,41,-6,3
2016,WA,9,205165,76317,281482,1,d,482952,238150,244802,739873,373885,365988,521562,217876,303686,739873,151855,157102,141200,98847,280742,90205,84671,105866,-12,10,12,-2,-10,-8,14,-4,-7,-22,44,-6,4
2016,WI,1,107003,230072,354245,0,r,529094,258205,270889,715327,623123,92204,490729,138354,352375,715327,111606,138528,157725,109391,276902,108351,94175,74376,-12,10,12,-2,-10,-8,14,-4,-7,-22,49,-6,3
2016,WI,2,273537,124044,398060,1,d,562881,274422,288459,757511,648982,108529,502603,214163,288440,757511,151111,143382,145126,106520,306923,115009,102445,89469,-12,10,12,-2,-10,-8,14,-4,-7,-22,48,-6,4
2016,WI,3,257401,0,260370,1,d,561353,281220,280133,721847,675090,46757,475427,120888,354539,721847,127042,122338,144986,122010,286437,135568,96207,54662,-12,10,12,-2,-10,-8,14,-4,-7,-22,45,-6,3
2016,WI,4,220181,0,286909,1,d,495903,232903,263000,713297,358739,354558,452828,124117,328711,713297,149613,133007,121971,80735,278710,156520,79318,42872,-12,10,12,-2,-10,-8,14,-4,-7,-22,61,-6,4
2016,WI,5,114477,260706,390844,1,r,556258,270531,285727,722739,661605,61134,507345,187095,320250,722739,113078,138447,155585,125062,294420,108011,97718,88691,-12,10,12,-2,-10,-8,14,-4,-7,-22,44,-6,3
2016,WI,6,133072,204147,357183,1,r,547178,274157,273021,711318,660137,51181,496489,131014,365475,711318,111289,132102,155224,126168,291448,126477,100075,64896,-12,10,12,-2,-10,-8,14,-4,-7,-22,44,-6,3
2016,WI,7,138643,223418,362271,1,r,549269,275068,274201,708541,661768,46773,505192,116686,388506,708541,94615,128860,161775,139790,294702,141068,97752,55882,-12,10,12,-2,-10,-8,14,-4,-7,-22,44,-6,3
2016,WI,8,135682,227892,363780,0,r,549784,272481,277303,728129,652244,75885,502716,127858,374858,728129,115285,139874,157110,117585,297456,127703,103355,66398,-12,10,12,-2,-10,-8,14,-4,-7,-22,42,-6,2
2016,WV,1,73534,163469,237003,1,r,489842,241566,248276,617131,581788,35343,430176,100918,329258,617131,101208,113312,126228,114935,240041,128724,68166,43151,-12,10,12,-2,-10,-8,14,-4,-7,-22,58,-6,4
2016,WV,2,101207,140807,242014,0,r,482402,234005,248397,622850,569457,53393,441453,94727,346726,622850,96627,117882,137216,112106,245164,125408,75660,44096,-12,10,12,-2,-10,-8,14,-4,-7,-22,61,-6,4
2016,WV,3,49708,140741,207332,0,r,466199,225578,240621,591121,552950,38171,420128,73112,347016,591121,85673,113116,124122,116734,236920,145712,63536,27672,-12,10,12,-2,-10,-8,14,-4,-7,-22,66,-6,3
2016,WY,1,75466,156176,258788,0,r,433794,220950,212844,585501,538819,46682,390794,105917,284877,585501,102679,106675,115562,87583,223619,96293,71311,56015,-12,10,12,-2,-10,-8,14,-4,-7,-22,40,-6,3
2018,AK,1,131199,149779,282166,1,r,532244,279792,252452,737438,474555,262883,485353,146428,338925,737438,147368,141686,137978,88000,254551,79186,83400,91965,-4,19,31,11,-1,-2,21,5,-5,-10,54,0,19
2018,AL,1,89226,153228,242617,1,r,544464,256603,287861,715346,479949,235397,491625,120204,371421,715346,113935,131114,144044,127083,272626,143203,80228,49195,-4,19,31,11,-1,-2,21,5,-5,-10,75,0,18
2018,AL,2,86931,138879,226230,1,r,516295,243971,272324,678122,426674,251448,461832,104391,357441,678122,120104,124416,132120,115362,254315,130453,77101,46761,-4,19,31,11,-1,-2,21,5,-5,-10,75,0,19
2018,AL,3,83996,147770,231915,1,r,543854,261066,282788,708409,490987,217422,476946,103690,373256,708409,118892,129189,138458,119519,264595,138715,76782,49098,-4,19,31,11,-1,-2,21,5,-5,-10,74,0,20
2018,AL,4,46492,184255,230969,0,r,515701,248166,267535,686297,591084,95213,471464,83684,387780,686297,103448,125785,137374,128143,256963,138863,73156,44944,-4,19,31,11,-1,-2,21,5,-5,-10,62,0,19
2018,AL,5,101388,159063,260673,1,r,551968,267633,284335,725634,539903,185731,502702,170855,331847,725634,121571,137913,148037,119725,290207,128579,87660,73968,-4,19,31,11,-1,-2,21,5,-5,-10,70,0,19
2018,AL,6,85644,192542,278328,0,r,535753,255440,280313,713595,556700,156895,496342,180385,315957,713595,116002,143702,138847,119052,266268,96804,84329,85135,-4,19,31,11,-1,-2,21,5,-5,-10,69,0,19
2018,AL,7,185010,0,189163,0,d,504177,230516,273661,660468,221541,438927,436553,88828,347725,660468,117656,114446,126377,100779,250210,152764,65180,32266,-4,19,31,11,-1,-2,21,5,-5,-10,78,0,19
2018,AR,1,57907,138757,201245,0,r,548710,270423,278287,724622,561702,162920,497168,84108,413060,724622,116365,133162,140625,131155,282730,164288,79790,38652,-4,19,31,11,-1,-2,21,5,-5,-10,73,0,18
2018,AR,2,116135,132125,253453,0,r,570220,271053,299167,765124,540548,224576,513347,154056,359291,765124,134188,143792,143461,121838,294135,146208,79224,68703,-4,19,31,11,-1,-2,21,5,-5,-10,72,0,20
2018,AR,3,74952,148717,229708,1,r,573113,277923,295190,819235,679803,139432,532481,150986,381495,819235,151532,153943,143351,118046,309456,144438,95561,69457,-4,19,31,11,-1,-2,21,5,-5,-10,49,0,19
2018,AR,4,63984,136740,204892,1,r,532069,255252,276817,704844,524043,180801,478943,82125,396818,704844,100617,121327,141664,136637,270026,157160,73511,39355,-4,19,31,11,-1,-2,21,5,-5,-10,70,0,18
2018,AZ,1,143240,122784,266089,1,d,568661,283123,285538,770392,504227,266165,509637,128652,380985,770392,120607,132953,135493,148829,260716,117920,84914,57882,-4,19,31,11,-1,-2,21,5,-5,-10,45,0,20
2018,AZ,2,161000,133083,294152,0,r,550044,267865,282179,724747,584070,140677,509692,169741,339951,724747,129309,122956,135167,157202,299328,140462,91540,67326,-4,19,31,11,-1,-2,21,5,-5,-10,47,0,20
2018,AZ,3,114650,64868,179518,0,d,500787,256566,244221,798359,564199,234160,486317,78995,407322,798359,159083,143811,127657,99419,248402,123173,82180,43049,-4,19,31,11,-1,-2,21,5,-5,-10,44,0,18
2018,AZ,4,84521,188842,277035,0,r,633528,318974,314554,809426,723818,85608,602060,120903,481157,809426,104043,128093,166894,224318,324737,153907,112866,57964,-4,19,31,11,-1,-2,21,5,-5,-10,45,0,19
2018,AZ,5,127027,186037,313064,1,r,587681,283913,303768,841344,700892,140452,559914,213963,345951,841344,123237,170902,147037,141143,294051,86867,92942,114242,-4,19,31,11,-1,-2,21,5,-5,-10,50,0,19
2018,AZ,6,140559,173140,313699,1,r,577899,279903,297996,783621,663178,120443,570764,257110,313654,783621,134318,151503,163799,149354,324886,108075,100673,116138,-4,19,31,11,-1,-2,21,5,-5,-10,49,0,19
2018,AZ,7,113044,0,132051,1,d,454957,226970,227987,854749,607405,247344,493478,77144,416334,854749,184611,163429,126208,60596,250303,135564,75549,39190,-4,19,31,11,-1,-2,21,5,-5,-10,46,0,19
2018,AZ,8,135569,168835,304417,0,r,599423,281157,318266,794820,656356,138464,569369,176313,393056,794820,111963,146181,148764,183219,294239,102404,101937,89898,-4,19,31,11,-1,-2,21,5,-5,-10,50,0,19
2018,AZ,9,159583,101662,261245,0,d,562791,280089,282702,794188,586360,207828,539073,215672,323401,794188,202324,149019,142003,95023,317636,129424,99866,88346,-4,19,31,11,-1,-2,21,5,-5,-10,50,0,19
2018,CA,1,131548,160046,291594,0,r,553702,276469,277233,711282,605294,105988,505797,125107,380690,711282,120286,114885,145072,155882,279836,127920,81974,69942,-4,19,31,11,-1,-2,21,5,-5,-10,48,0,18
2018,CA,10,115945,105955,221900,1,r,493409,242938,250471,761485,573461,188024,487698,84879,402819,761485,136762,147046,134569,98883,240621,91201,75654,73766,-4,19,31,11,-1,-2,21,5,-5,-10,45,0,18
2018,CA,11,204369,71312,275681,1,d,508963,245241,263722,762290,419654,342636,538421,247767,290654,762290,135252,151387,153793,127281,269243,71056,66444,131743,-4,19,31,11,-1,-2,21,5,-5,-10,51,0,20
2018,CA,12,275292,41780,317072,1,d,571300,292211,279089,764043,365047,398996,615231,377800,237431,764043,216790,174591,135605,116214,327144,87806,59982,179356,-4,19,31,11,-1,-2,21,5,-5,-10,53,0,20
2018,CA,13,260580,0,294837,1,d,536892,253135,283757,764304,312333,451971,548722,279115,269607,764304,175461,160170,135959,108061,288611,92737,70468,125406,-4,19,31,11,-1,-2,21,5,-5,-10,57,0,20
2018,CA,14,211384,55439,266823,1,d,511049,249886,261163,759415,328620,430795,552856,279469,273387,759415,143538,158077,151577,125644,251995,52918,57152,141925,-4,19,31,11,-1,-2,21,5,-5,-10,51,0,19
2018,CA,15,177989,65940,243929,1,d,503361,248705,254656,789174,314637,474537,547996,253175,294821,789174,134019,181416,153491,106877,251826,46937,58170,146719,-4,19,31,11,-1,-2,21,5,-5,-10,51,0,19
2018,CA,16,82266,60693,142959,1,d,423147,210027,213120,749967,422040,327927,444528,60475,384053,749967,147087,135197,115213,78134,214157,109770,66455,37932,-4,19,31,11,-1,-2,21,5,-5,-10,45,0,18
2018,CA,17,159105,52057,211162,1,d,438374,224282,214092,777468,222919,554549,562909,337342,225567,777468,181792,166681,144826,96078,260959,42876,45338,172745,-4,19,31,11,-1,-2,21,5,-5,-10,52,0,21
2018,CA,18,225142,77096,302238,1,d,491580,239626,251954,750295,474238,276057,528655,341362,187293,750295,122818,164316,151059,116195,270798,52074,49128,169596,-4,19,31,11,-1,-2,21,5,-5,-10,50,0,22
2018,CA,19,162496,57823,220319,1,d,482363,238475,243888,763028,334224,428804,516756,198245,318511,763028,147190,159327,140822,102973,233952,53947,57316,122689,-4,19,31,11,-1,-2,21,5,-5,-10,48,0,19
2018,CA,2,243081,72576,315657,1,d,534951,262941,272010,722370,575564,146806,518988,224276,294712,722370,98530,136726,154056,153503,284468,93394,75534,115540,-4,19,31,11,-1,-2,21,5,-5,-10,47,0,20
2018,CA,20,183677,0,225721,1,d,434889,216679,218210,739352,428821,310531,472859,133087,339772,739352,133855,137245,129325,103980,225394,73743,67511,84140,-4,19,31,11,-1,-2,21,5,-5,-10,43,0,20
2018,CA,21,57239,56377,113616,1,r,354669,190018,164651,713625,510358,203267,416523,38412,378111,713625,147681,139774,102474,64614,190073,104006,56328,29739,-4,19,31,11,-1,-2,21,5,-5,-10,43,0,18
2018,CA,22,105136,117243,222379,0,r,483064,228078,254986,771095,523341,247754,475085,125054,350031,771095,145555,138424,122632,99343,247092,101355,73505,72232,-4,19,31,11,-1,-2,21,5,-5,-10,45,0,19
2018,CA,23,74661,131113,205774,1,r,490446,247112,243334,747852,558772,189080,482289,97349,384940,747852,138852,137347,135320,98579,247855,110785,72186,64884,-4,19,31,11,-1,-2,21,5,-5,-10,47,0,19
2018,CA,24,166550,117881,284431,1,d,508333,253408,254925,738707,605269,133438,473796,165031,308765,738707,136696,122581,130160,127463,256673,84079,77566,95028,-4,19,31,11,-1,-2,21,5,-5,-10,44,0,20
2018,CA,25,133209,111813,245022,0,r,482964,235314,247650,716257,453617,262640,467623,133906,333717,716257,117428,138954,144891,93789,222661,69143,61329,92189,-4,19,31,11,-1,-2,21,5,-5,-10,48,0,18
2018,CA,26,158216,97210,255426,1,d,480928,235049,245879,728927,590235,138692,490142,158964,331178,728927,127737,137593,141918,111657,229606,69382,65049,95175,-4,19,31,11,-1,-2,21,5,-5,-10,44,0,19
2018,CA,27,202636,0,202636,1,d,471963,224505,247458,705509,266686,438823,513288,221128,292160,705509,123352,140818,144277,127057,239888,83456,63167,93265,-4,19,31,11,-1,-2,21,5,-5,-10,50,0,19
2018,CA,28,196662,54272,250934,1,d,502971,246827,256144,709450,489020,220430,551128,250178,300950,709450,160129,158298,148960,110736,297507,111143,77853,108511,-4,19,31,11,-1,-2,21,5,-5,-10,48,0,19
2018,CA,29,124697,29995,154692,0,d,402898,196524,206374,707741,389138,318603,474655,99706,374949,707741,150835,145570,129525,82368,207024,94285,62043,50696,-4,19,31,11,-1,-2,21,5,-5,-10,43,0,16
2018,CA,3,134875,97376,232251,1,d,504299,246961,257338,748104,512748,235356,480161,127145,353016,748104,140811,131029,134545,107218,250729,92231,76555,81943,-4,19,31,11,-1,-2,21,5,-5,-10,50,0,20
2018,CA,30,191573,69420,260993,1,d,529846,256236,273610,766513,475246,291267,548092,245798,302294,766513,149699,161451,151999,119121,275934,84117,76935,114882,-4,19,31,11,-1,-2,21,5,-5,-10,49,0,19
2018,CA,31,110143,77352,187495,1,d,482081,230379,251702,751527,472619,278908,475560,117976,357584,751527,152939,141446,127906,88386,222791,84455,68471,69865,-4,19,31,11,-1,-2,21,5,-5,-10,48,0,19
2018,CA,32,121759,55272,177031,0,d,449452,213040,236412,716199,369379,346820,478759,104720,374039,716199,135190,142922,137577,96564,195295,68052,62340,64903,-4,19,31,11,-1,-2,21,5,-5,-10,44,0,18
2018,CA,33,219091,93769,312860,0,d,517251,251819,265432,704818,506075,198743,509499,332731,176768,704818,118833,138985,137422,132040,288478,64417,64250,159811,-4,19,31,11,-1,-2,21,5,-5,-10,53,0,20
2018,CA,34,110195,0,151906,0,d,425520,215755,209765,748812,259995,488817,541078,155355,385723,748812,197613,158089,127185,93848,260836,135186,68224,57426,-4,19,31,11,-1,-2,21,5,-5,-10,46,0,17
2018,CA,35,103420,45604,149024,1,d,450565,220837,229728,769589,341427,428162,477370,84286,393084,769589,165088,156202,122537,74498,201610,72116,75247,54247,-4,19,31,11,-1,-2,21,5,-5,-10,44,0,17
2018,CA,36,122169,84839,207008,1,d,536333,262414,273919,752138,500142,251996,549044,117127,431917,752138,117231,135041,149791,171562,289261,148253,76371,64637,-4,19,31,11,-1,-2,21,5,-5,-10,44,0,19
2018,CA,37,210555,25823,236378,1,d,468463,223584,244879,738174,355343,382831,515058,205524,309534,738174,183897,149399,131091,92876,274939,111331,76285,87323,-4,19,31,11,-1,-2,21,5,-5,-10,54,0,19
2018,CA,38,139188,62968,202156,0,d,481296,233542,247754,716331,292100,424231,491170,122102,369068,716331,139631,137422,135592,107550,204009,68168,61400,74441,-4,19,31,11,-1,-2,21,5,-5,-10,45,0,18
2018,CA,39,126002,118391,244393,0,r,486713,233873,252840,726541,366507,360034,499671,208652,291019,726541,142164,136863,143676,111862,222659,61325,60790,100544,-4,19,31,11,-1,-2,21,5,-5,-10,48,0,18
2018,CA,4,156253,184401,340654,1,r,573118,286496,286622,754525,636599,117926,546493,192754,353739,754525,105883,141474,162105,159881,283468,93416,80680,109372,-4,19,31,11,-1,-2,21,5,-5,-10,48,0,18
2018,CA,40,93938,0,121449,1,d,340435,165988,174447,716470,410493,305977,446649,48379,398270,716470,152694,149076,111013,67423,183200,88033,61002,34165,-4,19,31,11,-1,-2,21,5,-5,-10,42,0,17
2018,CA,41,108227,58021,166248,1,d,478613,237023,241590,775626,388905,386721,468342,83340,385002,775626,170227,142921,123332,73535,188128,67858,65571,54699,-4,19,31,11,-1,-2,21,5,-5,-10,46,0,19
2018,CA,42,100892,131040,231932,1,r,538265,269677,268588,826801,529560,297241,522051,136517,385534,826801,139579,167626,143823,99510,223844,57143,66519,100182,-4,19,31,11,-1,-2,21,5,-5,-10,47,0,18
2018,CA,43,152272,43780,196052,1,d,454185,213003,241182,753696,307860,445836,505046,141150,363896,753696,151420,153904,139620,92544,245576,94967,77621,72988,-4,19,31,11,-1,-2,21,5,-5,-10,53,0,18
2018,CA,44,143322,0,143322,0,d,395819,188238,207581,725177,320876,404301,453696,59755,393941,725177,146383,143530,118077,75324,190906,87593,61976,41337,-4,19,31,11,-1,-2,21,5,-5,-10,48,0,18
2018,CA,45,158906,146383,305289,0,r,532802,259823,272979,797608,495939,301669,549397,304799,244598,797608,132951,161383,160714,122823,281020,67500,63410,150110,-4,19,31,11,-1,-2,21,5,-5,-10,49,0,19
2018,CA,46,102278,45638,147916,1,d,408633,201808,206825,735139,420031,315108,471074,96060,375014,735139,166926,144849,121696,74590,191713,67913,65165,58635,-4,19,31,11,-1,-2,21,5,-5,-10,43,0,17
2018,CA,47,143354,77682,221036,0,d,491712,239510,252202,710853,363923,346930,497030,162596,334434,710853,147196,148214,143518,91255,249015,89960,76429,82626,-4,19,31,11,-1,-2,21,5,-5,-10,50,0,18
2018,CA,48,157837,136899,294736,1,r,529832,261462,268370,719486,459456,260030,526662,247954,278708,719486,122704,145814,155337,127774,266926,68957,70400,127569,-4,19,31,11,-1,-2,21,5,-5,-10,49,0,19
2018,CA,49,166453,128577,295030,0,r,519302,259293,260009,731513,572343,159170,503184,224014,279170,731513,121882,140984,146185,122829,254413,65944,66400,122069,-4,19,31,11,-1,-2,21,5,-5,-10,47,0,19
2018,CA,5,205860,0,261018,1,d,508369,242276,266093,730955,453797,277158,519139,167337,351802,730955,124606,140345,149746,130207,263687,78474,81159,104054,-4,19,31,11,-1,-2,21,5,-5,-10,50,0,19
2018,CA,50,125448,134362,259810,1,r,513522,254481,259041,751551,600933,150618,505430,144604,360826,751551,129539,146447,145127,112208,245440,80231,72808,92401,-4,19,31,11,-1,-2,21,5,-5,-10,45,0,19
2018,CA,51,109527,44301,153828,1,d,445034,231666,213368,747510,503283,244227,476612,74232,402380,747510,163796,137285,123783,88372,201521,100519,63816,37186,-4,19,31,11,-1,-2,21,5,-5,-10,45,0,17
2018,CA,52,188992,107015,296007,0,d,546843,277751,269092,767172,505924,261248,540301,321962,218339,767172,168988,156103,138643,112620,289177,70720,73546,144911,-4,19,31,11,-1,-2,21,5,-5,-10,51,0,21
2018,CA,53,185667,83127,268794,1,d,563962,280508,283454,796701,513966,282735,545869,204842,341027,796701,192573,161977,135739,99470,274582,82912,85148,106522,-4,19,31,11,-1,-2,21,5,-5,-10,50,0,19
2018,CA,6,201939,0,201939,0,d,506434,244392,262042,777985,386232,391753,516694,153460,363234,777985,174270,150478,129225,95748,275253,116522,84377,74354,-4,19,31,11,-1,-2,21,5,-5,-10,54,0,18
2018,CA,7,155016,126601,281617,1,d,537436,259003,278433,753640,474784,278856,522284,179332,342952,753640,127032,151973,151057,120191,267550,83530,79503,104517,-4,19,31,11,-1,-2,21,5,-5,-10,54,0,18
2018,CA,8,0,170785,170785,1,r,477512,240107,237405,717107,535884,181223,458979,76064,382915,717107,125009,131196,133538,96973,232969,106143,72757,54069,-4,19,31,11,-1,-2,21,5,-5,-10,48,0,19
2018,CA,9,113414,87349,200763,1,d,482967,234940,248027,775148,439731,335417,489305,98682,390623,775148,130443,147603,138300,103224,239810,86933,70997,81880,-4,19,31,11,-1,-2,21,5,-5,-10,50,0,18
2018,CO,1,272886,85207,369693,1,d,619349,309603,309746,841497,658995,182502,610028,309603,300425,841497,221152,180429,140217,100994,360309,127718,104067,128524,-4,19,31,11,-1,-2,21,5,-5,-10,51,0,19
2018,CO,2,259608,144901,430614,0,d,619285,309961,309324,812357,733767,78590,552557,309718,242839,812357,159519,153788,158255,122089,318851,95033,93901,129917,-4,19,31,11,-1,-2,21,5,-5,-10,47,0,20
2018,CO,3,146426,173205,336189,1,r,565901,280001,285900,753595,675510,78085,522152,166341,355811,753595,116106,136543,151393,140186,291169,132481,95417,63271,-4,19,31,11,-1,-2,21,5,-5,-10,42,0,18
2018,CO,4,145544,224038,369582,1,r,598599,302689,295910,836061,749846,86215,559028,201222,357806,836061,137162,168034,162369,116803,305869,96083,93201,116585,-4,19,31,11,-1,-2,21,5,-5,-10,45,0,18
2018,CO,5,126848,184002,322645,1,r,603967,309714,294253,815466,661068,154398,544143,202663,341480,815466,165331,152500,150641,115313,302267,112881,101679,87707,-4,19,31,11,-1,-2,21,5,-5,-10,53,0,20
2018,CO,6,187639,148685,346817,1,r,567801,277947,289854,835273,614542,220731,561380,239227,322153,835273,151608,181258,158381,101182,298909,87081,91733,120095,-4,19,31,11,-1,-2,21,5,-5,-10,54,0,19
2018,CO,7,204260,119734,338006,1,d,576138,283711,292427,801315,696949,104366,550999,196775,354224,801315,161756,163944,145022,111288,299383,97002,98287,104094,-4,19,31,11,-1,-2,21,5,-5,-10,44,0,19
2018,CT,1,166155,96024,274140,0,d,523004,247490,275514,715049,496973,218076,501456,185548,315908,715049,116949,135672,147055,124852,279563,98239,77915,103409,-4,19,31,11,-1,-2,21,5,-5,-10,59,0,20
2018,CT,2,167659,102483,289114,1,d,548572,272014,276558,699657,596505,103152,495348,179893,315455,699657,117375,124619,156173,126055,273946,84717,84857,104372,-4,19,31,11,-1,-2,21,5,-5,-10,56,0,20
2018,CT,3,163211,95667,270239,0,d,535024,251948,283076,712272,514402,197870,502396,183747,318649,712272,128220,130462,145640,124880,281432,100282,85763,95387,-4,19,31,11,-1,-2,21,5,-5,-10,59,0,21
2018,CT,4,168726,103175,275651,0,d,496370,234779,261591,739090,526763,212327,504198,257736,246462,739090,109879,146878,157492,115192,269293,78111,61484,129698,-4,19,31,11,-1,-2,21,5,-5,-10,56,0,21
2018,CT,5,142901,115146,270664,0,d,511395,246253,265142,706597,553493,153104,489998,180306,309692,706597,110394,134263,154104,122168,273857,102621,72572,98664,-4,19,31,11,-1,-2,21,5,-5,-10,53,0,20
2018,DC,1,0,0,0,0,,526393,245922,280471,702455,296747,405708,500176,302170,198006,702455,194226,143298,107785,85626,287476,95115,65762,126599,-4,19,31,11,-1,-2,21,5,-5,-10,71,0,23
2018,DE,1,227353,125384,352737,1,d,720867,343826,377041,967171,659781,307390,679700,212992,466708,967171,161184,173836,197708,180756,367671,143911,117502,106258,-4,19,31,11,-1,-2,21,5,-5,-10,67,0,20
2018,FL,1,106199,216189,322388,1,r,601423,300883,300540,784532,601815,182717,540835,154094,386741,784532,142874,142864,155307,132405,295098,126627,94379,74092,-4,19,31,11,-1,-2,21,5,-5,-10,66,0,19
2018,FL,10,1,0,1,1,d,546157,262516,283641,839504,479216,360288,566800,187886,378914,839504,174774,175562,150816,97785,270167,119919,82073,68175,-4,19,31,11,-1,-2,21,5,-5,-10,60,0,18
2018,FL,11,128053,239395,367506,1,r,652135,313750,338385,789849,693614,96235,623655,131068,492587,789849,88251,109211,161089,281669,331750,174989,104694,52067,-4,19,31,11,-1,-2,21,5,-5,-10,57,0,19
2018,FL,12,132844,194564,334918,0,r,605983,285091,320892,792410,686843,105567,587377,168541,418836,792410,101469,146726,165734,193965,312209,145831,95576,70802,-4,19,31,11,-1,-2,21,5,-5,-10,53,0,19
2018,FL,13,182717,134254,316971,1,d,584889,281217,303672,735935,580519,155416,566215,175902,390313,735935,122464,130834,167211,171584,303069,143701,90956,68412,-4,19,31,11,-1,-2,21,5,-5,-10,61,0,19
2018,FL,14,1,0,1,1,d,534225,253933,280292,782973,531821,251152,538446,202128,336318,782973,158958,163398,142071,104514,307827,139037,85486,83304,-4,19,31,11,-1,-2,21,5,-5,-10,55,0,19
2018,FL,15,134132,151380,285532,0,r,578715,278594,300121,808723,598144,210579,555023,142808,412215,808723,150045,148863,156856,132949,285074,126067,94339,64668,-4,19,31,11,-1,-2,21,5,-5,-10,57,0,18
2018,FL,16,164463,197483,361946,1,r,638769,302288,336481,852096,709176,142920,635191,203809,431382,852096,109426,146684,175593,226843,331394,134492,101108,95794,-4,19,31,11,-1,-2,21,5,-5,-10,54,0,20
2018,FL,17,117194,193326,310520,0,r,615104,301114,313990,789236,680864,108372,600266,132398,467868,789236,92492,116133,152051,255782,301158,145811,96627,58720,-4,19,31,11,-1,-2,21,5,-5,-10,53,0,19
2018,FL,18,156454,185905,342359,1,r,599873,288462,311411,780772,611308,169464,589563,196890,392673,780772,105633,136417,166954,201423,301578,123440,90834,87304,-4,19,31,11,-1,-2,21,5,-5,-10,59,0,19
2018,FL,19,128106,211465,339607,1,r,631233,300597,330636,836359,711481,124878,643636,220783,422853,836359,105220,130328,166244,264638,325244,137856,95871,91517,-4,19,31,11,-1,-2,21,5,-5,-10,52,0,19
2018,FL,2,96233,199335,295568,1,r,573718,290954,282764,733749,587260,146489,519856,119149,400707,733749,111903,137281,148149,148454,278448,144464,82371,51613,-4,19,31,11,-1,-2,21,5,-5,-10,66,0,19
2018,FL,20,202659,0,202824,1,d,507613,242726,264887,809153,295544,513609,538659,108552,430107,809153,152911,160308,151895,108899,247772,128951,76762,42059,-4,19,31,11,-1,-2,21,5,-5,-10,67,0,19
2018,FL,21,1,0,1,1,d,546101,255769,290332,785042,601527,183515,583587,208214,375373,785042,119622,137070,150046,201501,296189,123947,89026,83216,-4,19,31,11,-1,-2,21,5,-5,-10,56,0,19
2018,FL,22,184634,113049,297683,0,d,534846,265302,269544,753363,575793,177570,570391,232187,338204,753363,112500,149703,166592,165568,308398,119839,88251,100308,-4,19,31,11,-1,-2,21,5,-5,-10,57,0,19
2018,FL,23,161611,99446,276366,1,d,510212,242283,267929,756447,533202,223245,533254,214284,318970,756447,116102,152180,151552,137835,274559,110302,76312,87945,-4,19,31,11,-1,-2,21,5,-5,-10,52,0,20
2018,FL,24,1,0,1,0,,477697,220770,256927,784469,337035,447434,538996,119617,419379,784469,158175,158432,147086,107971,251800,145923,71185,34692,-4,19,31,11,-1,-2,21,5,-5,-10,61,0,18
2018,FL,25,84173,128672,212845,1,r,453055,212439,240616,775326,697177,78149,565161,151233,413928,775326,131609,154567,157782,147636,241423,110288,77543,53592,-4,19,31,11,-1,-2,21,5,-5,-10,42,0,19
2018,FL,26,119797,115678,235475,1,r,476033,225950,250083,790373,624225,166148,540673,155851,384822,790373,136085,163611,156237,117449,229243,94877,74415,59951,-4,19,31,11,-1,-2,21,5,-5,-10,45,0,18
2018,FL,27,130743,115588,252586,0,r,464604,222276,242328,763812,669096,94716,575784,247289,328495,763812,138961,168829,151955,140704,284927,120866,73819,90242,-4,19,31,11,-1,-2,21,5,-5,-10,43,0,20
2018,FL,3,129880,176616,306496,0,r,579993,282160,297833,758275,565612,192663,506270,143762,362508,758275,137413,137715,140595,128208,273236,133270,83019,56947,-4,19,31,11,-1,-2,21,5,-5,-10,64,0,19
2018,FL,4,123351,248420,381249,0,r,614794,301588,313206,819177,662790,156387,578329,238038,340291,819177,142246,159705,164260,137230,314432,106878,102101,105453,-4,19,31,11,-1,-2,21,5,-5,-10,60,0,19
2018,FL,5,180527,89799,270326,1,d,541992,254528,287464,738862,331585,407277,483118,95783,387335,738862,154677,134756,134075,98265,272454,155090,80845,36519,-4,19,31,11,-1,-2,21,5,-5,-10,73,0,18
2018,FL,6,145758,187891,333649,0,r,621566,296982,324584,781896,641307,140589,583848,142443,441405,781896,111798,129406,165812,200306,307602,145470,99178,62954,-4,19,31,11,-1,-2,21,5,-5,-10,58,0,18
2018,FL,7,183113,134285,317398,1,d,581583,282311,299272,786041,583016,203025,539345,221655,317690,786041,159457,157053,143152,114061,294369,112867,92639,88863,-4,19,31,11,-1,-2,21,5,-5,-10,53,0,19
2018,FL,8,142415,218112,360527,1,r,610604,293057,317547,768139,639295,128844,578037,178235,399802,768139,102905,125594,172972,195565,288761,124562,91046,73153,-4,19,31,11,-1,-2,21,5,-5,-10,59,0,19
2018,FL,9,172172,124565,296737,1,d,644898,313560,331338,902812,670309,232503,619810,154631,465179,902812,159384,184451,165045,145575,281177,128192,94556,58429,-4,19,31,11,-1,-2,21,5,-5,-10,50,0,19
2018,GA,1,105942,144741,250683,0,r,550713,265885,284828,744385,467721,276664,494931,127041,367890,744385,141670,140484,135383,109215,278248,133514,85957,58777,-4,19,31,11,-1,-2,21,5,-5,-10,72,0,20
2018,GA,10,112339,190396,302735,0,r,565803,272442,293361,767352,515879,251473,498587,134889,363698,767352,127414,148752,145179,110981,267759,113863,81956,71940,-4,19,31,11,-1,-2,21,5,-5,-10,71,0,20
2018,GA,11,118653,191887,310540,1,r,559687,265122,294565,781313,570501,210812,525231,226536,298695,781313,145570,159819,147974,102184,291526,93399,89212,108915,-4,19,31,11,-1,-2,21,5,-5,-10,64,0,19
2018,GA,12,101503,148986,250492,1,r,540482,263096,277386,723334,417208,306126,469166,102282,366884,723334,126432,133694,133134,102894,247424,132093,70445,44886,-4,19,31,11,-1,-2,21,5,-5,-10,73,0,20
2018,GA,13,223157,69760,293010,1,d,523476,234458,289018,757521,220074,537447,494970,147409,347561,757521,130336,162232,144277,85526,258975,102739,89528,66708,-4,19,31,11,-1,-2,21,5,-5,-10,72,0,19
2018,GA,14,53981,175743,229724,1,r,516434,247683,268751,722873,620751,102122,482226,86819,395407,722873,116578,146067,140494,107260,256402,128092,75869,52441,-4,19,31,11,-1,-2,21,5,-5,-10,59,0,18
2018,GA,2,136699,92472,229171,0,d,498322,237183,261139,665539,281955,383584,437215,75342,361873,665539,115731,120158,123118,105503,246910,149160,65195,32555,-4,19,31,11,-1,-2,21,5,-5,-10,76,0,20
2018,GA,3,101010,191996,293006,1,r,548941,261012,287929,740700,499401,241299,494617,134007,360610,740700,115148,145100,144886,114866,268358,114018,81326,73014,-4,19,31,11,-1,-2,21,5,-5,-10,72,0,19
2018,GA,4,227717,61092,288809,0,d,527938,243040,284898,785104,210961,574143,518415,169344,349071,785104,141485,160743,152099,95657,270528,112448,89267,68813,-4,19,31,11,-1,-2,21,5,-5,-10,73,0,19
2018,GA,5,275406,0,275406,0,d,587385,276291,311094,793039,251276,541763,524341,233590,290751,793039,196298,156794,126072,86695,319839,143138,90371,86330,-4,19,31,11,-1,-2,21,5,-5,-10,75,0,20
2018,GA,6,160139,156875,317032,0,r,496468,243742,252726,754299,518775,235524,524810,333281,191529,754299,121115,171395,152966,98851,287599,68398,78509,140692,-4,19,31,11,-1,-2,21,5,-5,-10,59,0,19
2018,GA,7,140011,140430,280441,1,r,486845,226855,259990,803976,434102,369874,517070,221303,295767,803976,128431,179456,153226,84707,265599,82297,84553,98749,-4,19,31,11,-1,-2,21,5,-5,-10,59,0,19
2018,GA,8,0,198152,198716,1,r,527338,251135,276203,714720,446473,268247,474114,105312,368802,714720,122074,133828,133424,109323,262218,141740,71983,48495,-4,19,31,11,-1,-2,21,5,-5,-10,72,0,20
2018,GA,9,57912,224661,282578,1,r,556967,270985,285982,765320,672568,92752,522479,126878,395601,765320,117092,140684,148057,142766,281627,122581,90350,68696,-4,19,31,11,-1,-2,21,5,-5,-10,54,0,19
2018,HI,1,134650,42498,184211,0,d,509992,259092,250900,709286,122457,586829,506157,186272,319885,709286,133618,139236,130192,132970,231296,65011,68135,98150,-4,19,31,11,-1,-2,21,5,-5,-10,53,0,18
2018,HI,2,153271,44850,198121,1,d,506514,254001,252513,711205,223195,488010,489432,147301,342131,711205,126144,127999,135668,128497,224013,77357,63006,83650,-4,19,31,11,-1,-2,21,5,-5,-10,53,0,19
2018,IA,1,170342,153442,334243,1,r,580187,284027,296160,773628,701592,72036,520840,141631,379209,773628,122330,136236,150733,139220,311514,128617,110274,72623,-4,19,31,11,-1,-2,21,5,-5,-10,61,0,18
2018,IA,2,171446,133287,312913,0,d,581525,284369,297156,783983,700399,83584,520211,148209,372002,783983,130282,140432,149811,134426,313626,141572,98203,73851,-4,19,31,11,-1,-2,21,5,-5,-10,58,0,19
2018,IA,3,175642,167933,356241,1,r,601044,292105,308939,843598,743399,100199,563735,195317,368418,843598,144793,165867,157097,123357,330429,122769,108688,98972,-4,19,31,11,-1,-2,21,5,-5,-10,56,0,18
2018,IA,4,147246,157676,313251,1,r,564463,278749,285714,754936,700709,54227,500006,125383,374623,754936,120240,125779,146510,140815,312304,136874,109085,66345,-4,19,31,11,-1,-2,21,5,-5,-10,51,0,18
2018,ID,1,96922,197719,315069,0,r,661724,327753,333971,912950,815218,97732,608857,158140,450717,912950,144108,167890,171302,155498,332386,146080,111489,74817,-4,19,31,11,-1,-2,21,5,-5,-10,46,0,18
2018,ID,2,110381,170274,280655,0,r,590690,295212,295478,841258,761628,79630,534890,158122,376768,841258,151450,152390,144643,123943,307884,139802,102884,65198,-4,19,31,11,-1,-2,21,5,-5,-10,44,0,18
2018,IL,1,189560,50960,257885,1,d,524114,239139,284975,706550,303613,402937,483745,144264,339481,706550,126230,130240,144031,112861,269599,122971,76596,70032,-4,19,31,11,-1,-2,21,5,-5,-10,73,0,20
2018,IL,10,156540,82124,238664,1,d,468255,228987,239268,711265,493441,217824,473001,221040,251961,711265,114718,137265,140428,109894,251936,78117,70528,103291,-4,19,31,11,-1,-2,21,5,-5,-10,50,0,20
2018,IL,11,145407,82358,227765,1,d,472244,230365,241879,722584,496219,226365,473863,167312,306551,722584,119526,154648,136993,90133,249169,75462,80195,93512,-4,19,31,11,-1,-2,21,5,-5,-10,52,0,19
2018,IL,12,118724,134884,261543,1,r,528398,258312,270086,687072,533450,153622,477589,113239,364350,687072,118485,126563,140207,117968,277817,137198,85260,55359,-4,19,31,11,-1,-2,21,5,-5,-10,73,0,20
2018,IL,13,134458,136516,270981,1,r,539012,262945,276067,704211,570733,133478,452705,135832,316873,704211,128696,122813,128795,111496,286809,138729,86703,61377,-4,19,31,11,-1,-2,21,5,-5,-10,67,0,20
2018,IL,14,156035,141164,297199,0,r,525729,258410,267319,742235,645869,96366,495509,208222,287287,742235,104621,154529,154624,102747,262859,57739,80757,124363,-4,19,31,11,-1,-2,21,5,-5,-10,52,0,19
2018,IL,15,74309,181294,255608,0,r,532371,263271,269100,691196,639755,51441,481560,95742,385818,691196,103965,124411,142024,133930,276514,130487,91691,54336,-4,19,31,11,-1,-2,21,5,-5,-10,65,0,19
2018,IL,16,104569,151254,255825,1,r,520730,258813,261917,684888,619708,65180,473279,115001,358278,684888,105483,125015,143858,124590,274557,111477,88313,74767,-4,19,31,11,-1,-2,21,5,-5,-10,53,0,19
2018,IL,17,142659,87090,229749,1,d,512994,250502,262492,679926,553346,126580,467867,91108,376759,679926,110129,120953,136479,126888,280917,144890,89441,46586,-4,19,31,11,-1,-2,21,5,-5,-10,64,0,18
2018,IL,18,95486,195927,291413,0,r,531334,256746,274588,700276,628155,72121,485104,162251,322853,700276,104090,127348,141438,133504,279760,106634,92891,80235,-4,19,31,11,-1,-2,21,5,-5,-10,63,0,19
2018,IL,2,190684,44567,235251,0,d,497132,220603,276529,694459,253856,440603,458822,103842,354980,694459,114094,129993,130410,111159,257381,130438,76641,50302,-4,19,31,11,-1,-2,21,5,-5,-10,72,0,20
2018,IL,3,163053,57885,223334,0,d,479004,239389,239615,704050,554906,149144,481409,136664,344745,704050,117429,139576,140651,108168,246239,92137,73520,80582,-4,19,31,11,-1,-2,21,5,-5,-10,47,0,19
2018,IL,4,143895,22294,166189,0,d,410804,198815,211989,702062,420391,281671,466352,120989,345363,702062,160910,149292,117969,71791,233844,105771,70885,57188,-4,19,31,11,-1,-2,21,5,-5,-10,43,0,19
2018,IL,5,213992,65134,279131,1,d,545831,264796,281035,743699,594110,149589,543553,303852,239701,743699,203096,152822,129354,95746,304941,87120,82630,135191,-4,19,31,11,-1,-2,21,5,-5,-10,49,0,20
2018,IL,6,169001,146445,315446,1,r,523796,256062,267734,730345,600898,129447,506744,269284,237460,730345,99525,145712,163057,119204,270115,61434,69549,139132,-4,19,31,11,-1,-2,21,5,-5,-10,51,0,20
2018,IL,7,215746,30497,246243,1,d,522767,245563,277204,707513,264669,442844,501978,211317,290661,707513,181993,135499,122054,96514,301839,138810,68811,94218,-4,19,31,11,-1,-2,21,5,-5,-10,67,0,21
2018,IL,8,130054,67073,197127,1,d,442009,210434,231575,707268,454580,252688,477198,164464,312734,707268,135160,142807,133498,97618,250552,81850,84285,84417,-4,19,31,11,-1,-2,21,5,-5,-10,49,0,19
2018,IL,9,213368,76983,290351,1,d,498242,242188,256054,721481,507446,214035,506098,288261,217837,721481,119028,142926,142019,126337,290016,101097,75972,112947,-4,19,31,11,-1,-2,21,5,-5,-10,57,0,20
2018,IN,1,159611,85594,245209,1,d,537218,259331,277887,714756,492098,222658,489062,115821,373241,714756,115736,136492,146099,118463,276543,122255,86702,67586,-4,19,31,11,-1,-2,21,5,-5,-10,62,0,19
2018,IN,2,103363,125499,228889,1,r,522778,254316,268462,723483,616378,107105,477898,113151,364747,723483,115429,130157,137892,118817,276707,127172,94698,54837,-4,19,31,11,-1,-2,21,5,-5,-10,58,0,19
2018,IN,3,86610,158927,245537,1,r,540022,263081,276941,747060,646328,100732,490891,117994,372897,747060,125357,135932,142924,115773,288583,126590,101918,60075,-4,19,31,11,-1,-2,21,5,-5,-10,61,0,19
2018,IN,4,87824,156539,244363,0,r,567094,281136,285958,768025,679224,88801,498607,138800,359807,768025,127810,141598,146010,118000,292185,120987,101158,70040,-4,19,31,11,-1,-2,21,5,-5,-10,57,0,19
2018,IN,5,137142,180035,317177,1,r,573500,273289,300211,784462,651421,133041,533259,245371,287888,784462,135281,159543,152278,116399,306483,106802,91731,107950,-4,19,31,11,-1,-2,21,5,-5,-10,64,0,19
2018,IN,6,79430,154260,241726,0,r,549035,267782,281253,719771,668943,50828,489920,108991,380929,719771,119594,129262,145793,127419,286401,133607,99419,53375,-4,19,31,11,-1,-2,21,5,-5,-10,61,0,19
2018,IN,7,141139,76457,217596,0,d,521076,242838,278238,760466,438167,322299,493773,123443,370330,760466,156934,142123,133109,92272,292119,160757,85471,45891,-4,19,31,11,-1,-2,21,5,-5,-10,69,0,18
2018,IN,8,86895,157396,244291,0,r,549149,270738,278411,718591,659502,59089,490519,106805,383714,718591,118035,131633,145903,124660,287940,134607,97086,56247,-4,19,31,11,-1,-2,21,5,-5,-10,66,0,18
2018,IN,9,118090,153271,271361,1,r,575308,279976,295332,755264,687866,67398,503964,140690,363274,755264,130318,140606,145143,119343,292208,128590,98935,64683,-4,19,31,11,-1,-2,21,5,-5,-10,60,0,19
2018,KS,1,71558,153082,224640,1,r,502712,254352,248360,698323,622552,75771,445692,115531,330161,698323,124621,115227,125362,115910,273007,135789,91546,45672,-4,19,31,11,-1,-2,21,5,-5,-10,49,0,19
2018,KS,2,123859,126098,264688,0,r,538594,266041,272553,713845,617745,96100,471249,141554,329695,713845,114058,127847,134851,123084,282985,134302,88824,59859,-4,19,31,11,-1,-2,21,5,-5,-10,59,0,20
2018,KS,3,170518,139762,318301,1,r,534532,258428,276104,775243,619413,155830,518077,246441,271636,775243,135869,156952,145973,108784,296249,94151,91234,110864,-4,19,31,11,-1,-2,21,5,-5,-10,57,0,19
2018,KS,4,98445,144248,242693,0,r,515676,253444,262232,724099,587113,136986,476408,142617,333791,724099,124122,129261,137337,114413,281167,126957,89972,64238,-4,19,31,11,-1,-2,21,5,-5,-10,56,0,19
2018,KY,1,78849,172167,251016,1,r,552530,269167,283363,721124,641142,79982,489762,88517,401245,721124,112970,128118,144050,133233,282020,155983,80658,45379,-4,19,31,11,-1,-2,21,5,-5,-10,68,0,20
2018,KY,2,79964,171700,257345,0,r,577362,282075,295287,769850,685076,84774,516740,106750,409990,769850,122899,144197,151684,124068,290818,142819,91050,56949,-4,19,31,11,-1,-2,21,5,-5,-10,64,0,20
2018,KY,3,173002,101930,278720,1,d,553926,261136,292790,749110,525539,223571,518347,174243,344104,749110,139441,139935,146432,120473,302502,138391,91323,72788,-4,19,31,11,-1,-2,21,5,-5,-10,71,0,20
2018,KY,4,90536,162946,261812,1,r,565232,277020,288212,754387,693312,61075,514606,152725,361881,754387,122628,146482,153894,116906,284807,110891,90515,83401,-4,19,31,11,-1,-2,21,5,-5,-10,61,0,19
2018,KY,5,45890,172093,218017,0,r,537877,263796,274081,695105,674403,20702,481463,65239,416224,695105,107587,133725,142747,121959,266607,169345,67876,29386,-4,19,31,11,-1,-2,21,5,-5,-10,64,0,21
2018,KY,6,144736,154468,302888,1,r,581992,279091,302901,778826,655551,123275,518496,166311,352185,778826,147938,148335,148900,114753,305959,144708,93280,67971,-4,19,31,11,-1,-2,21,5,-5,-10,66,0,20
2018,LA,1,71521,192555,269325,1,r,594231,282992,311239,806638,634048,172590,555546,170952,384594,806638,137119,153729,161182,130195,300739,132549,88549,79641,-4,19,31,11,-1,-2,21,5,-5,-10,64,0,19
2018,LA,2,190182,0,235982,0,d,587115,273178,313937,794121,247841,546280,544711,129164,415547,794121,148898,152697,155188,115542,296535,175253,70935,50347,-4,19,31,11,-1,-2,21,5,-5,-10,75,0,19
2018,LA,3,74713,168263,245943,1,r,577604,275886,301718,783545,551911,231634,519623,115316,404307,783545,136500,146847,149950,115222,297581,151103,83558,62920,-4,19,31,11,-1,-2,21,5,-5,-10,74,0,18
2018,LA,4,72934,139326,216872,1,r,559310,272704,286606,747314,448036,299278,493036,98327,394709,747314,122157,136495,138410,122592,286839,166743,71855,48241,-4,19,31,11,-1,-2,21,5,-5,-10,76,0,18
2018,LA,5,67118,149018,223946,0,r,555804,274214,281590,738249,448097,290152,492141,84923,407218,738249,117981,136437,140240,121256,262611,151748,67119,43744,-4,19,31,11,-1,-2,21,5,-5,-10,77,0,18
2018,LA,6,76716,186553,268525,1,r,585015,276949,308066,790111,547182,242929,520676,159971,360705,790111,157075,147163,141525,115803,292915,117137,86381,89397,-4,19,31,11,-1,-2,21,5,-5,-10,73,0,19
2018,MA,1,211790,0,216900,1,d,568024,266490,301534,736481,626384,110097,508753,156520,352233,736481,122025,130908,154250,132153,288420,127905,81725,78790,-4,19,31,11,-1,-2,21,5,-5,-10,52,0,20
2018,MA,2,191332,93391,284893,1,d,558962,269755,289207,745347,613709,131638,510441,208853,301588,745347,125593,138405,156691,121700,280279,102957,80217,97105,-4,19,31,11,-1,-2,21,5,-5,-10,56,0,20
2018,MA,3,173175,93445,279327,0,d,543580,267058,276522,771096,572967,198129,523817,200758,323059,771096,130599,149744,167713,105527,279358,91347,78388,109623,-4,19,31,11,-1,-2,21,5,-5,-10,50,0,20
2018,MA,4,245289,0,251016,0,d,559943,264258,295685,766019,651373,114646,526546,270977,255569,766019,110576,148613,165097,127736,279926,70497,70579,138850,-4,19,31,11,-1,-2,21,5,-5,-10,56,0,22
2018,MA,5,236243,74856,311324,1,d,535109,254313,280796,775135,581993,193142,555728,333520,222208,775135,150871,161651,148729,125377,300644,78057,71255,151332,-4,19,31,11,-1,-2,21,5,-5,-10,55,0,22
2018,MA,6,217703,104798,333975,0,d,577241,273324,303917,780524,659720,120804,555323,258256,297067,780524,120588,143895,170717,146196,294705,87452,73469,133784,-4,19,31,11,-1,-2,21,5,-5,-10,54,0,20
2018,MA,7,216559,0,220411,0,d,558430,261887,296543,820086,413896,406190,554818,261522,293296,820086,248425,149524,121849,89349,308906,119481,78872,110553,-4,19,31,11,-1,-2,21,5,-5,-10,61,0,21
2018,MA,8,259159,0,263307,1,d,561241,271141,290100,764891,565686,199205,558223,269536,288687,764891,161815,147570,155375,124671,301338,85843,76074,139421,-4,19,31,11,-1,-2,21,5,-5,-10,63,0,20
2018,MA,9,192347,131463,323928,0,d,573274,272549,300725,742570,649447,93123,539079,192068,347011,742570,106568,132603,161516,164832,290718,103405,84763,102550,-4,19,31,11,-1,-2,21,5,-5,-10,56,0,20
2018,MD,1,116631,183662,306132,1,r,567926,274632,293294,741621,604948,136673,518744,167159,351585,741621,111016,132990,162524,138984,277758,92823,82607,102328,-4,19,31,11,-1,-2,21,5,-5,-10,68,0,20
2018,MD,2,167201,77782,253302,0,d,560167,260668,299499,768511,405867,362644,527126,181264,345862,768511,148603,152553,148150,109606,286945,99173,92320,95452,-4,19,31,11,-1,-2,21,5,-5,-10,71,0,20
2018,MD,3,202407,82774,292880,0,d,545892,264371,281521,754636,465062,289574,523206,261993,261213,754636,151735,147158,142014,115494,288000,75376,80717,131907,-4,19,31,11,-1,-2,21,5,-5,-10,67,0,21
2018,MD,4,209642,53327,268583,1,d,503398,233987,269411,760398,211823,548575,526041,179780,346261,760398,140284,157076,154182,103193,271766,69304,90607,111855,-4,19,31,11,-1,-2,21,5,-5,-10,69,0,20
2018,MD,5,213796,82361,304209,1,d,556897,266835,290062,757621,358663,398958,508910,190728,318182,757621,120677,149680,160933,105734,262835,58300,73575,130960,-4,19,31,11,-1,-2,21,5,-5,-10,71,0,20
2018,MD,6,163346,105209,276974,0,d,523698,256158,267540,758943,504729,254214,520754,217985,302769,758943,125165,152454,153489,118748,273544,86026,76846,110672,-4,19,31,11,-1,-2,21,5,-5,-10,58,0,21
2018,MD,7,202345,56266,264710,0,d,528398,244249,284149,716136,251762,464374,496290,197431,298859,716136,136336,134077,142103,113001,270505,111061,75350,84094,-4,19,31,11,-1,-2,21,5,-5,-10,74,0,21
2018,MD,8,217679,96525,319330,1,d,533774,255084,278690,784852,502193,282659,546268,304355,241913,784852,123790,160459,159926,126281,284582,62791,67635,154156,-4,19,31,11,-1,-2,21,5,-5,-10,58,0,22
2018,ME,1,201195,111188,342053,1,d,546625,262366,284259,685535,642636,42899,506273,198126,308147,685535,110703,127508,153478,138926,295578,111561,96539,87478,-4,19,31,11,-1,-2,21,5,-5,-10,59,0,19
2018,ME,2,139231,136326,281371,0,r,524036,256001,268035,652869,618817,34052,477109,111924,365185,652869,93511,116160,150221,137143,274729,144984,83799,45946,-4,19,31,11,-1,-2,21,5,-5,-10,59,0,18
2018,MI,1,145246,187251,332497,1,r,564858,286708,278150,699220,643692,55528,509929,133954,375975,699220,100509,115213,156626,163475,293025,142529,99011,51485,-4,19,31,11,-1,-2,21,5,-5,-10,59,0,19
2018,MI,10,106061,182808,303064,1,r,553804,272084,281720,722722,664624,58098,512339,121925,390414,722722,102131,137861,164036,132553,286251,112445,87651,86155,-4,19,31,11,-1,-2,21,5,-5,-10,59,0,19
2018,MI,11,181912,158463,350901,0,r,534817,258134,276683,733920,586668,147252,520046,256061,263985,733920,115789,145435,160482,123503,287025,81459,83602,121964,-4,19,31,11,-1,-2,21,5,-5,-10,59,0,20
2018,MI,12,200588,85115,294628,1,d,526943,255173,271770,709832,549015,160817,466599,169610,296989,709832,150633,122332,131245,103976,277461,118474,85020,73967,-4,19,31,11,-1,-2,21,5,-5,-10,64,0,21
2018,MI,13,165355,0,196299,0,d,474739,220128,254611,663867,260452,403415,438363,72153,366210,663867,119908,121762,126109,97265,266256,172801,66178,27277,-4,19,31,11,-1,-2,21,5,-5,-10,74,0,19
2018,MI,14,214334,45899,264994,0,d,512851,237874,274977,704494,244398,460096,483376,153744,329632,704494,132491,125991,137936,117809,277198,142372,73577,61249,-4,19,31,11,-1,-2,21,5,-5,-10,76,0,21
2018,MI,2,131254,168970,305463,1,r,551323,270056,281267,743361,625058,118303,493384,132101,361283,743361,129415,133292,142749,119587,277873,118966,95330,63577,-4,19,31,11,-1,-2,21,5,-5,-10,58,0,18
2018,MI,3,134185,169107,310740,1,r,551028,269805,281223,749975,627466,122509,502819,164988,337831,749975,136035,138365,143918,112791,283940,116380,94612,72948,-4,19,31,11,-1,-2,21,5,-5,-10,62,0,19
2018,MI,4,106540,178510,285050,0,r,554938,275776,279162,704592,659539,45053,486940,105184,381756,704592,111889,121335,146565,137477,279730,135853,92045,51832,-4,19,31,11,-1,-2,21,5,-5,-10,56,0,20
2018,MI,5,164502,99265,276413,1,d,520558,249502,271056,671115,519531,151584,467251,94075,373176,671115,102821,119267,142591,124550,283846,150847,83519,49480,-4,19,31,11,-1,-2,21,5,-5,-10,71,0,19
2018,MI,6,134082,147436,293438,1,r,541981,263696,278285,721736,607696,114040,481239,140036,341203,721736,122174,127558,141954,124855,285178,127003,92824,65351,-4,19,31,11,-1,-2,21,5,-5,-10,63,0,19
2018,MI,7,136330,158730,295060,1,r,548462,271940,276522,706811,644695,62116,496225,128405,367820,706811,106137,129613,152568,130623,279677,112802,95810,71065,-4,19,31,11,-1,-2,21,5,-5,-10,61,0,19
2018,MI,8,172880,159782,341593,0,r,554462,270121,284341,749011,635322,113689,493390,201110,292280,749011,123327,139108,150604,112636,281718,97268,87216,97234,-4,19,31,11,-1,-2,21,5,-5,-10,60,0,20
2018,MI,9,181734,112123,304563,0,d,552114,266809,285305,715259,557129,158130,517946,158547,359399,715259,147289,133806,149712,119353,298288,122999,94886,80403,-4,19,31,11,-1,-2,21,5,-5,-10,71,0,19
2018,MN,1,144885,146200,291661,0,d,500330,247189,253141,678418,606439,71979,452944,135012,317932,678418,112805,121294,131087,117573,272152,112081,88664,71407,-4,19,31,11,-1,-2,21,5,-5,-10,55,0,18
2018,MN,2,177958,159344,337968,1,r,511914,247867,264047,714141,601405,112736,475931,190965,284966,714141,111272,146122,143003,99093,264954,71650,81542,111762,-4,19,31,11,-1,-2,21,5,-5,-10,59,0,18
2018,MN,3,202404,160839,363949,1,r,517834,251195,266639,723994,569372,154622,507943,260169,247774,723994,107989,148728,156080,114683,282744,75352,79322,128070,-4,19,31,11,-1,-2,21,5,-5,-10,63,0,19
2018,MN,4,216865,97747,328614,1,d,510862,243687,267175,717766,500450,217316,483064,217437,265627,717766,140736,133425,133077,104637,271654,95563,81900,94191,-4,19,31,11,-1,-2,21,5,-5,-10,61,0,19
2018,MN,5,267703,74440,343358,0,d,517155,256364,260791,718802,484065,234737,492936,235509,257427,718802,186578,136506,114934,91072,297469,114707,88078,94684,-4,19,31,11,-1,-2,21,5,-5,-10,64,0,19
2018,MN,6,122332,192931,315726,1,r,525551,264594,260957,722715,646833,75882,472879,145951,326928,722715,114193,146556,144508,94077,257420,72981,82897,101542,-4,19,31,11,-1,-2,21,5,-5,-10,61,0,18
2018,MN,7,146672,134668,281509,1,d,495727,245413,250314,663069,599813,63256,449385,99881,349504,663069,102462,110149,132623,130239,269318,114751,94200,60367,-4,19,31,11,-1,-2,21,5,-5,-10,52,0,17
2018,MN,8,141950,159364,314211,0,d,527541,266984,260557,672274,620998,51276,474147,113204,360943,672274,98443,117025,145933,137260,278741,124235,89338,65168,-4,19,31,11,-1,-2,21,5,-5,-10,59,0,18
2018,MO,1,219781,45867,274375,0,d,549361,253168,296193,728365,315884,412481,501988,168186,333802,728365,163512,132068,137369,106576,321228,169604,92738,58886,-4,19,31,11,-1,-2,21,5,-5,-10,77,0,20
2018,MO,2,177611,192477,376066,1,r,575828,272618,303210,760689,669924,90765,539757,268434,271323,760689,110609,145162,164561,143830,301587,83956,88448,129183,-4,19,31,11,-1,-2,21,5,-5,-10,60,0,20
2018,MO,3,106589,211243,324608,1,r,602748,295360,307388,793405,736054,57351,546487,148279,398208,793405,131042,151193,164141,128004,302574,113465,107656,81453,-4,19,31,11,-1,-2,21,5,-5,-10,65,0,19
2018,MO,4,95968,190138,293316,1,r,584925,289078,295847,770500,686709,83791,505995,131840,374155,770500,135219,131651,143999,130398,294174,144418,92880,56876,-4,19,31,11,-1,-2,21,5,-5,-10,62,0,20
2018,MO,5,175019,101069,283785,0,d,573775,274276,299499,771847,530873,240974,528670,151529,377141,771847,152214,142821,143850,119698,319116,152161,97566,69389,-4,19,31,11,-1,-2,21,5,-5,-10,69,0,19
2018,MO,6,97660,199796,305409,1,r,583457,287409,296048,780002,702748,77254,525089,152805,372284,780002,122961,146315,154735,128534,290010,117607,97688,74715,-4,19,31,11,-1,-2,21,5,-5,-10,61,0,19
2018,MO,7,89190,196343,296455,1,r,595559,287998,307561,783672,715501,68171,526468,125116,401352,783672,138136,138495,147607,138312,319781,173126,96607,50048,-4,19,31,11,-1,-2,21,5,-5,-10,55,0,19
2018,MO,8,66151,194042,264399,1,r,567717,280877,286840,737972,677504,60468,508333,89705,418628,737972,109785,131314,153298,139722,286336,165241,81480,39615,-4,19,31,11,-1,-2,21,5,-5,-10,69,0,19
2018,MS,1,76601,158245,236521,1,r,577880,274187,303693,769595,519886,249709,508584,107439,401145,769595,121846,144990,146364,121547,281673,146281,85498,49894,-4,19,31,11,-1,-2,21,5,-5,-10,76,0,19
2018,MS,2,158921,0,221379,1,d,523479,246408,277071,695797,218531,477266,454762,91539,363223,695797,108055,126417,135317,106751,252354,154797,69132,28425,-4,19,31,11,-1,-2,21,5,-5,-10,80,0,19
2018,MS,3,94461,160284,257271,0,r,559913,263747,296166,746155,444887,301268,497655,140469,357186,746155,124777,141728,135900,122887,281354,147291,79289,54774,-4,19,31,11,-1,-2,21,5,-5,-10,77,0,20
2018,MS,4,68787,152633,223732,0,r,579386,278636,300750,774983,552151,222832,516282,119247,397035,774983,131510,147392,145723,123238,293249,157548,86178,49523,-4,19,31,11,-1,-2,21,5,-5,-10,73,0,19
2018,MT,1,233284,256661,504421,0,r,823668,413026,410642,1062305,941438,120867,735761,233405,502356,1062305,173092,189208,212338,200239,431421,195552,143005,92864,-4,19,31,11,-1,-2,21,5,-5,-10,49,0,19
2018,NC,1,190457,82218,272675,1,d,566173,262291,303882,761087,363018,398069,515614,148906,366708,761087,131483,138977,144259,126081,294568,159230,81956,53382,-4,19,31,11,-1,-2,21,5,-5,-10,73,0,20
2018,NC,10,113259,164969,278228,0,r,585102,277020,308082,762919,614574,148345,542715,137102,405613,762919,118664,143653,162589,140903,301589,145675,96460,59454,-4,19,31,11,-1,-2,21,5,-5,-10,66,0,18
2018,NC,11,116508,178012,300666,1,r,604505,289081,315424,768166,694680,73486,564194,148581,415613,768166,108563,140892,164368,173932,314271,162821,95249,56201,-4,19,31,11,-1,-2,21,5,-5,-10,54,0,19
2018,NC,12,203974,75164,279138,0,d,591843,275402,316441,880550,405087,475463,588949,240926,348023,880550,200762,188818,151337,87139,337331,140758,104889,91684,-4,19,31,11,-1,-2,21,5,-5,-10,67,0,18
2018,NC,13,130402,147570,286316,1,r,579274,271691,307583,788131,541609,246522,540188,158428,381760,788131,129184,149215,158499,130778,311205,152147,93605,65453,-4,19,31,11,-1,-2,21,5,-5,-10,68,0,18
2018,NC,2,151977,170072,331704,1,r,601142,291498,309644,858938,609822,249116,573248,207310,365938,858938,126712,184009,171775,117604,305705,106549,94395,104761,-4,19,31,11,-1,-2,21,5,-5,-10,66,0,19
2018,NC,3,0,187901,187901,1,r,579504,293180,286324,756375,548289,208086,503822,125434,378388,756375,141389,129416,142360,132134,293837,145424,95122,53291,-4,19,31,11,-1,-2,21,5,-5,-10,68,0,19
2018,NC,4,247067,82052,341403,0,d,624834,294403,330431,871589,525115,346474,585165,334801,250364,871589,182586,183750,154151,102109,341534,113490,107465,120579,-4,19,31,11,-1,-2,21,5,-5,-10,65,0,20
2018,NC,5,120468,159917,280385,1,r,572721,271575,301146,762960,601222,161738,526068,138470,387598,762960,116964,138790,156852,138964,307844,161078,92106,54660,-4,19,31,11,-1,-2,21,5,-5,-10,64,0,19
2018,NC,6,123651,160709,284360,0,r,567392,268248,299144,772716,550198,222518,534169,136454,397715,772716,113889,145400,161298,136131,300648,145511,88576,66561,-4,19,31,11,-1,-2,21,5,-5,-10,67,0,18
2018,NC,7,120838,156809,282312,1,r,613510,291864,321646,809820,608837,200983,567798,150560,417238,809820,129869,144725,162520,160657,319287,160777,99160,59350,-4,19,31,11,-1,-2,21,5,-5,-10,67,0,18
2018,NC,8,114119,141402,255521,1,r,581896,280980,300916,797935,525543,272392,530163,147361,382802,797935,144314,152613,145638,119587,298551,139551,93160,65840,-4,19,31,11,-1,-2,21,5,-5,-10,66,0,19
2018,NC,9,138341,139246,282717,0,r,561804,267655,294149,792434,510575,281859,530051,192468,337583,792434,117038,159186,156163,122555,285092,119981,75970,89141,-4,19,31,11,-1,-2,21,5,-5,-10,67,0,19
2018,ND,1,0,193568,321532,0,r,567351,291026,276325,760077,651687,108390,500779,148610,352169,760077,155689,131630,135981,116433,319355,125093,102008,92254,-4,19,31,11,-1,-2,21,5,-5,-10,60,0,17
2018,NE,1,93069,141712,234781,1,r,473676,236555,237121,653684,574575,79109,419722,138084,281638,653684,121759,118087,116803,99097,258151,106191,84981,66979,-4,19,31,11,-1,-2,21,5,-5,-10,52,0,19
2018,NE,2,121770,126715,248485,1,r,467041,226651,240390,673005,544472,128533,440288,179645,260643,673005,126285,133095,118699,86041,259585,94664,83333,81588,-4,19,31,11,-1,-2,21,5,-5,-10,59,0,19
2018,NE,3,49654,163650,213304,1,r,439543,216125,223418,602579,547943,54636,406430,93001,313429,602579,87121,103121,115880,118860,247754,119126,82161,46467,-4,19,31,11,-1,-2,21,5,-5,-10,46,0,18
2018,NH,1,155884,130996,291039,0,d,540224,265533,274691,686820,632042,54778,486021,179133,306888,686820,113718,125983,150613,120363,267830,87559,80825,99446,-4,19,31,11,-1,-2,21,5,-5,-10,56,0,19
2018,NH,2,155358,117990,279705,0,d,529588,260293,269295,669638,621889,47749,484727,178446,306281,669638,99046,123840,157332,124793,263382,91735,78679,92968,-4,19,31,11,-1,-2,21,5,-5,-10,53,0,20
2018,NJ,1,169628,87617,263418,0,d,542034,258989,283045,731297,486685,244612,503965,160694,343271,731297,126440,142616,149019,113725,268996,98049,75971,94976,-4,19,31,11,-1,-2,21,5,-5,-10,61,0,19
2018,NJ,10,175253,20191,200159,0,d,496051,234506,261545,759704,218853,540851,513776,165244,348532,759704,152474,153577,141716,98861,275644,119230,82582,73832,-4,19,31,11,-1,-2,21,5,-5,-10,67,0,19
2018,NJ,11,183684,136322,323574,0,r,548734,261914,286820,744805,605871,138934,526416,301286,225130,744805,109744,150717,161457,132036,272269,50672,65115,156482,-4,19,31,11,-1,-2,21,5,-5,-10,52,0,20
2018,NJ,12,173334,79041,252375,1,d,505683,242465,263218,756016,429129,326887,523547,251415,272132,756016,118810,160562,156697,116715,273477,79673,68939,124865,-4,19,31,11,-1,-2,21,5,-5,-10,58,0,20
2018,NJ,2,136685,116866,258363,0,r,531339,257404,273935,703117,524102,179015,500738,137513,363225,703117,110367,127938,152529,136834,261689,102503,80491,78695,-4,19,31,11,-1,-2,21,5,-5,-10,58,0,19
2018,NJ,3,153473,149500,306875,0,r,570276,276793,293483,742905,588304,154601,530057,183369,346688,742905,119557,135921,160096,142831,282262,83823,87720,110719,-4,19,31,11,-1,-2,21,5,-5,-10,62,0,19
2018,NJ,4,126766,163065,294348,1,r,539643,253208,286435,748858,637678,111180,511097,220387,290710,748858,104256,133283,151386,147151,278958,82358,76897,119703,-4,19,31,11,-1,-2,21,5,-5,-10,56,0,19
2018,NJ,5,169546,128255,301823,0,d,527932,252797,275135,730707,578080,152627,510715,250097,260618,730707,101059,142513,163473,131230,263762,61967,60634,141161,-4,19,31,11,-1,-2,21,5,-5,-10,53,0,19
2018,NJ,6,140752,80443,221195,0,d,502463,247252,255211,730114,452053,278061,495748,198602,297146,730114,131688,142905,147953,105000,248676,71185,69656,107835,-4,19,31,11,-1,-2,21,5,-5,-10,54,0,19
2018,NJ,7,166985,150785,322742,0,r,527076,254674,272402,730778,573645,157133,508978,281360,227618,730778,95349,147734,169658,120534,262845,53960,59250,149635,-4,19,31,11,-1,-2,21,5,-5,-10,53,0,20
2018,NJ,8,119881,28725,153455,1,d,425604,207269,218335,764837,408879,355958,532943,189708,343235,764837,183615,168240,128337,82392,287023,114517,76615,95891,-4,19,31,11,-1,-2,21,5,-5,-10,48,0,19
2018,NJ,9,140832,57854,200416,0,d,481499,230505,250994,765382,453260,312122,531263,185317,345946,765382,138568,158380,153145,110980,273966,98977,75589,99400,-4,19,31,11,-1,-2,21,5,-5,-10,50,0,18
2018,NM,1,147336,90507,249162,0,d,514775,249488,265287,697064,550912,146152,487426,166892,320534,697064,130848,129999,137605,117458,278769,137703,78045,63021,-4,19,31,11,-1,-2,21,5,-5,-10,43,0,21
2018,NM,2,101489,97767,199256,0,r,484702,239241,245461,700113,585804,114309,454457,95084,359373,700113,117139,120398,122954,122410,256162,146269,68872,41021,-4,19,31,11,-1,-2,21,5,-5,-10,42,0,19
2018,NM,3,155201,76427,244893,0,d,507907,246780,261127,698251,463222,235029,474598,129736,344862,698251,110850,125827,132063,128612,259162,131604,76553,51005,-4,19,31,11,-1,-2,21,5,-5,-10,42,0,20
2018,NV,1,100707,46978,152201,1,d,418811,211011,207800,685427,339750,345677,466958,73801,393157,685427,140010,135778,124645,99661,255618,154034,70702,30882,-4,19,31,11,-1,-2,21,5,-5,-10,50,0,18
2018,NV,2,120102,167435,287537,1,r,531489,268234,263255,729771,578423,151348,510159,137877,372282,729771,128553,135164,146295,126080,289415,108321,99108,81986,-4,19,31,11,-1,-2,21,5,-5,-10,46,0,19
2018,NV,3,148501,122566,286168,0,d,607915,298190,309725,846761,534704,312057,605199,199394,405805,846761,151223,182769,161410,133739,316876,102699,105269,108908,-4,19,31,11,-1,-2,21,5,-5,-10,54,0,19
2018,NV,4,121962,102748,234868,0,d,516951,258915,258036,772433,472099,300334,514258,110762,403496,772433,130699,149499,143178,115640,267901,116246,82863,68792,-4,19,31,11,-1,-2,21,5,-5,-10,54,0,19
2018,NY,1,124213,121562,270053,0,r,530436,257571,272865,718726,616452,102274,502039,184595,317444,718726,110492,133071,154405,129004,250870,64683,64259,121928,-4,19,31,11,-1,-2,21,5,-5,-10,53,0,21
2018,NY,10,162131,33692,210958,0,d,473542,221514,252028,711678,495680,215998,508878,317917,190961,711678,159620,143914,120614,114159,307017,99794,59692,147531,-4,19,31,11,-1,-2,21,5,-5,-10,52,0,21
2018,NY,11,96850,80440,192173,0,r,500998,237048,263950,732886,498843,234043,513642,187008,326634,732886,125191,141557,149367,123577,263966,93842,67808,102316,-4,19,31,11,-1,-2,21,5,-5,-10,53,0,19
2018,NY,12,205858,30446,251877,1,d,530252,250793,279459,698928,506188,192740,556586,411819,144767,698928,230119,141343,108503,110208,356778,87217,76465,193096,-4,19,31,11,-1,-2,21,5,-5,-10,54,0,21
2018,NY,13,171341,9535,190688,1,d,505003,232128,272875,795633,203890,591743,566265,179982,386283,795633,200207,164826,139090,101638,294395,158817,74973,60605,-4,19,31,11,-1,-2,21,5,-5,-10,55,0,20
2018,NY,14,110318,19202,141204,0,d,392398,194391,198007,706440,298774,407666,504062,138741,365321,706440,150511,162687,122920,94455,244262,103976,74205,66081,-4,19,31,11,-1,-2,21,5,-5,-10,49,0,19
2018,NY,15,122007,4566,129751,0,d,410819,184098,226721,743959,128998,614961,460179,64593,395586,743959,155318,137011,124395,80341,259910,178443,58130,23337,-4,19,31,11,-1,-2,21,5,-5,-10,55,0,17
2018,NY,16,172815,0,183356,1,d,498243,223699,274544,732981,334077,398904,511487,208524,302963,732981,119381,142054,147981,127802,272787,103560,69568,99659,-4,19,31,11,-1,-2,21,5,-5,-10,61,0,21
2018,NY,17,159923,0,193841,1,d,502861,241981,260880,741445,516482,224963,491609,237155,254454,741445,114644,140117,143741,124138,248008,64725,59095,124188,-4,19,31,11,-1,-2,21,5,-5,-10,54,0,21
2018,NY,18,126368,96345,251690,1,d,524373,258678,265695,722226,550259,171967,484791,176148,308643,722226,116346,135306,153496,110816,251264,76842,68382,106040,-4,19,31,11,-1,-2,21,5,-5,-10,56,0,21
2018,NY,19,135582,112304,287986,0,r,553713,276166,277547,700310,614586,85724,505428,150285,355143,700310,101878,124544,157883,144119,271736,107139,86677,77920,-4,19,31,11,-1,-2,21,5,-5,-10,57,0,20
2018,NY,2,108803,112565,241217,1,r,515987,252580,263407,709605,555103,154502,492875,156700,336175,709605,117614,143566,154269,108985,226611,51711,59897,115003,-4,19,31,11,-1,-2,21,5,-5,-10,52,0,20
2018,NY,20,161330,89058,266014,0,d,557251,266403,290848,722529,567734,154795,491277,193434,297843,722529,128258,131483,141870,123308,289470,109480,87579,92411,-4,19,31,11,-1,-2,21,5,-5,-10,63,0,21
2018,NY,21,93394,116433,235267,1,r,551303,283623,267680,701112,643832,57280,490781,122354,368427,701112,116422,127572,150251,125887,278649,121704,91794,65151,-4,19,31,11,-1,-2,21,5,-5,-10,60,0,21
2018,NY,22,116001,110125,251212,0,r,539437,265317,274120,697372,619968,77404,477783,121841,355942,697372,109628,118226,145070,130497,271702,125892,87117,58693,-4,19,31,11,-1,-2,21,5,-5,-10,60,0,21
2018,NY,23,100914,114722,240374,0,r,544564,267455,277109,693764,626291,67473,473876,122531,351345,693764,108272,117701,145072,130512,279327,134876,89815,54636,-4,19,31,11,-1,-2,21,5,-5,-10,59,0,21
2018,NY,24,115902,113538,260477,0,r,539797,260293,279504,701664,591774,109890,483948,151213,332735,701664,115632,123872,147318,122161,279952,119662,85955,74335,-4,19,31,11,-1,-2,21,5,-5,-10,65,0,21
2018,NY,25,147979,91342,270120,0,d,543698,257318,286380,718565,537966,180599,496802,197961,298841,718565,131404,127688,143506,123290,291950,126396,85029,80525,-4,19,31,11,-1,-2,21,5,-5,-10,64,0,21
2018,NY,26,156968,61488,230663,1,d,539694,255091,284603,707190,497126,210064,493407,165629,327778,707190,135573,123196,138599,123251,306927,149064,95161,62702,-4,19,31,11,-1,-2,21,5,-5,-10,68,0,20
2018,NY,27,128167,114506,285300,0,r,564383,278943,285440,712904,667423,45481,515913,163408,352505,712904,105665,129342,165878,137103,289472,109261,92822,87389,-4,19,31,11,-1,-2,21,5,-5,-10,60,0,21
2018,NY,3,149937,98716,267062,1,d,521235,248504,272731,707576,518549,189027,506822,282755,224067,707576,100131,125549,162645,146620,247880,50970,49992,146918,-4,19,31,11,-1,-2,21,5,-5,-10,52,0,21
2018,NY,4,156728,90306,260206,1,d,506457,240633,265824,729582,468149,261433,504635,216514,288121,729582,116371,142911,146888,125392,237243,56220,53501,127522,-4,19,31,11,-1,-2,21,5,-5,-10,56,0,21
2018,NY,5,160500,0,161471,1,d,501784,232458,269326,757972,132518,625454,525692,144520,381172,757972,143015,143152,159319,110647,229294,77968,68896,82430,-4,19,31,11,-1,-2,21,5,-5,-10,66,0,18
2018,NY,6,104293,0,123421,1,d,448065,212441,235624,734183,313127,421056,546791,208367,338424,734183,130952,147020,161405,130286,271901,103121,81647,87133,-4,19,31,11,-1,-2,21,5,-5,-10,51,0,19
2018,NY,7,134125,0,157302,0,d,446196,214479,231717,720811,363279,357532,492168,182821,309347,720811,173293,145345,120213,84981,256906,111420,59437,86049,-4,19,31,11,-1,-2,21,5,-5,-10,50,0,20
2018,NY,8,170850,0,191567,1,d,540660,233029,307631,791211,246189,545022,553549,197186,356363,791211,174969,155336,139102,118829,303604,141244,74714,87646,-4,19,31,11,-1,-2,21,5,-5,-10,69,0,19
2018,NY,9,167269,18702,203423,1,d,486880,218455,268425,730957,262344,468613,521058,207465,313593,730957,164677,144098,131079,110059,285134,114499,79179,91456,-4,19,31,11,-1,-2,21,5,-5,-10,70,0,20
2018,OH,1,141118,154409,300871,1,r,541695,262456,279239,740979,528785,212194,496867,180207,316660,740979,126755,135603,146315,111917,294505,120450,89246,84809,-4,19,31,11,-1,-2,21,5,-5,-10,72,0,20
2018,OH,10,118785,157554,281726,0,r,552514,263435,289079,725301,553451,171850,495831,153494,342337,725301,126039,127561,141402,128971,300596,140053,91684,68859,-4,19,31,11,-1,-2,21,5,-5,-10,73,0,20
2018,OH,11,206138,44486,250660,1,d,524803,238090,286713,678001,269493,408508,470989,137019,333970,678001,126524,115532,138866,119878,304410,180670,73737,50003,-4,19,31,11,-1,-2,21,5,-5,-10,76,0,20
2018,OH,12,161251,175677,341647,0,r,585940,290618,295322,789634,683722,105912,540057,229935,310122,789634,133141,158603,154108,123476,293383,94934,90819,107630,-4,19,31,11,-1,-2,21,5,-5,-10,63,0,19
2018,OH,13,153323,98047,251370,1,d,559931,268927,291004,707603,580914,126689,491864,116631,375233,707603,122565,123236,145252,132490,298600,154401,92628,51571,-4,19,31,11,-1,-2,21,5,-5,-10,69,0,19
2018,OH,14,137549,169809,307358,1,r,553668,266077,287591,720551,649331,71220,512870,189185,323685,720551,100972,131644,158084,145548,286240,100196,91032,95012,-4,19,31,11,-1,-2,21,5,-5,-10,63,0,19
2018,OH,15,116112,170593,292443,1,r,586092,292487,293605,759569,679312,80257,528142,173251,354891,759569,135311,150610,148620,120773,290228,114712,92354,83162,-4,19,31,11,-1,-2,21,5,-5,-10,65,0,20
2018,OH,16,129681,170029,299710,0,r,553316,269087,284229,719864,662093,57771,512952,181663,331289,719864,106436,128683,152444,145737,287919,100507,97865,89547,-4,19,31,11,-1,-2,21,5,-5,-10,61,0,19
2018,OH,2,119333,166714,289661,0,r,557971,267271,290700,734712,626756,107956,509459,164563,344896,734712,128421,139868,149622,119527,298409,127979,91680,78750,-4,19,31,11,-1,-2,21,5,-5,-10,70,0,19
2018,OH,3,181575,65040,246677,1,d,560963,262190,298773,812264,435291,376973,521203,152595,368608,812264,182135,150532,135858,84005,316961,163350,98575,55036,-4,19,31,11,-1,-2,21,5,-5,-10,72,0,19
2018,OH,4,89412,167993,257405,1,r,542874,269636,273238,707219,637111,70108,483517,91360,392157,707219,108127,130376,148050,123452,277353,124535,95280,57538,-4,19,31,11,-1,-2,21,5,-5,-10,64,0,19
2018,OH,5,99655,176569,283617,0,r,549171,265489,283682,717088,654248,62840,488734,132068,356666,717088,105642,128653,147019,130512,289660,117713,97754,74193,-4,19,31,11,-1,-2,21,5,-5,-10,57,0,20
2018,OH,6,76716,172774,249490,1,r,545803,271382,274421,694694,658447,36247,494829,83828,411001,694694,99953,125231,153759,139032,275828,143398,85920,46510,-4,19,31,11,-1,-2,21,5,-5,-10,69,0,19
2018,OH,7,107536,153117,260653,1,r,557024,267916,289108,734091,677610,56481,501895,107206,394689,734091,109773,133534,147993,135066,285123,126156,91763,67204,-4,19,31,11,-1,-2,21,5,-5,-10,66,0,19
2018,OH,8,87281,173852,261133,1,r,546406,263947,282459,731637,640979,90658,486651,119815,366836,731637,112440,133956,146172,123430,282277,124708,88538,69031,-4,19,31,11,-1,-2,21,5,-5,-10,65,0,19
2018,OH,9,157219,74670,231937,1,d,545749,263532,282217,716235,533397,182838,491175,112790,378385,716235,141879,127239,143338,112349,303955,165789,89844,48322,-4,19,31,11,-1,-2,21,5,-5,-10,64,0,19
2018,OK,1,103042,150129,253171,0,r,565812,270452,295360,803029,578684,224345,532697,161541,371156,803029,143980,150960,147476,120002,310290,138247,96365,75678,-4,19,31,11,-1,-2,21,5,-5,-10,59,0,18
2018,OK,2,65021,140451,216002,1,r,564213,275370,288843,747632,494182,253450,506693,88122,418571,747632,114645,131745,144678,141541,284540,160606,80184,43750,-4,19,31,11,-1,-2,21,5,-5,-10,59,0,18
2018,OK,3,61152,172913,234065,1,r,571661,285869,285792,778026,617671,160355,508943,116973,391970,778026,128678,140172,142626,125904,280204,130634,91441,58129,-4,19,31,11,-1,-2,21,5,-5,-10,53,0,18
2018,OK,4,78088,149227,236638,1,r,589702,291854,297848,791927,591941,199986,521913,132683,389230,791927,145376,147125,143531,118261,296883,130979,98545,67359,-4,19,31,11,-1,-2,21,5,-5,-10,58,0,19
2018,OK,5,121149,117811,238960,1,r,561277,266722,294555,822465,563428,259037,537367,168842,368525,822465,158964,151581,145381,113893,313393,151093,95833,66467,-4,19,31,11,-1,-2,21,5,-5,-10,58,0,19
2018,OR,1,231198,116446,363249,1,d,606198,294448,311750,858910,682996,175914,597355,254424,342931,858910,159923,180144,162714,127814,330630,106694,96498,127438,-4,19,31,11,-1,-2,21,5,-5,-10,49,0,19
2018,OR,2,145298,207597,368709,1,r,619186,305421,313765,831343,752017,79326,590276,153523,436753,831343,129764,148341,165564,173438,332236,150201,111419,70616,-4,19,31,11,-1,-2,21,5,-5,-10,44,0,19
2018,OR,3,279019,76187,384326,1,d,627716,309299,318417,841456,665732,175724,613590,255344,358246,841456,182208,192161,154863,114251,331954,117871,100804,113279,-4,19,31,11,-1,-2,21,5,-5,-10,54,0,19
2018,OR,4,208710,152414,372893,0,d,638548,313807,324741,814998,708868,106130,571109,155520,415589,814998,139707,139644,157621,173359,331882,156157,110283,65442,-4,19,31,11,-1,-2,21,5,-5,-10,48,0,19
2018,OR,5,197187,149887,358469,1,d,606523,295492,311031,844006,705370,138636,580050,183732,396318,844006,143382,156283,162779,150749,313268,119204,100901,93163,-4,19,31,11,-1,-2,21,5,-5,-10,45,0,19
2018,PA,1,160745,169053,329798,0,d,544860,264421,280439,713685,610837,102848,511027,212434,298593,713685,107326,134028,164009,131951,271426,72141,80932,118353,-4,19,31,11,-1,-2,21,5,-5,-10,57,0,20
2018,PA,10,141668,149365,291033,0,r,552761,266462,286299,734849,581621,153228,509145,166674,342471,734849,124444,138995,147403,126901,292987,116356,91910,84721,-4,19,31,11,-1,-2,21,5,-5,-10,63,0,19
2018,PA,11,113876,163708,277584,0,r,553568,269825,283743,737394,656429,80965,505794,137074,368720,737394,117649,129245,146983,135491,279475,101069,98312,80094,-4,19,31,11,-1,-2,21,5,-5,-10,54,0,19
2018,PA,12,82825,161047,243872,0,r,551022,273160,277862,701192,657365,43827,474837,110947,363890,701192,106430,118938,141034,134560,273471,128119,87302,58050,-4,19,31,11,-1,-2,21,5,-5,-10,59,0,19
2018,PA,13,74733,178533,253266,0,d,545111,268312,276799,692835,647318,45517,497131,98161,398970,692835,100907,124810,149677,143768,278224,127792,95535,54897,-4,19,31,11,-1,-2,21,5,-5,-10,61,0,20
2018,PA,14,110051,151386,261437,0,d,551164,268241,282923,684084,641786,42298,500816,135736,365080,684084,99480,122616,154713,146513,288288,123340,89333,75615,-4,19,31,11,-1,-2,21,5,-5,-10,68,0,19
2018,PA,15,78327,165245,243572,0,r,548615,278000,270615,680927,649327,31600,490514,105283,385231,680927,107290,118538,150983,141099,278784,138834,88479,51471,-4,19,31,11,-1,-2,21,5,-5,-10,62,0,19
2018,PA,16,124109,135348,262396,0,r,539710,262719,276991,686525,623500,63025,482206,130025,352181,686525,103581,120667,146507,134058,284137,137515,89206,57416,-4,19,31,11,-1,-2,21,5,-5,-10,66,0,19
2018,PA,17,183162,142417,325579,0,d,559285,270617,288668,717264,629316,87948,527144,218411,308733,717264,117114,133096,157756,139791,308678,115800,90862,102016,-4,19,31,11,-1,-2,21,5,-5,-10,67,0,19
2018,PA,18,231472,0,231472,0,r,544390,254384,290006,683571,506153,177418,490639,191654,298985,683571,143134,116305,133160,128401,314778,150097,90332,74349,-4,19,31,11,-1,-2,21,5,-5,-10,73,0,20
2018,PA,2,159600,42382,201982,0,d,496510,234087,262423,727380,333199,394181,489967,105307,384660,727380,146135,136691,132940,97633,256540,143223,67760,45557,-4,19,31,11,-1,-2,21,5,-5,-10,60,0,18
2018,PA,3,287610,20387,307997,0,r,564612,253086,311526,736340,242730,493610,511382,210937,300445,736340,195127,129713,122553,101895,305996,153328,80643,72025,-4,19,31,11,-1,-2,21,5,-5,-10,75,0,21
2018,PA,4,211524,121467,332991,0,r,543723,260436,283287,727449,578350,149099,515013,245775,269238,727449,116820,141187,152412,129655,277740,72404,83935,121401,-4,19,31,11,-1,-2,21,5,-5,-10,63,0,20
2018,PA,5,198639,106075,304714,0,r,519983,243516,276467,718076,460206,257870,488815,184442,304373,718076,126049,134329,140406,115180,265508,99296,75876,90336,-4,19,31,11,-1,-2,21,5,-5,-10,70,0,20
2018,PA,6,177704,124124,301828,0,r,522912,252469,270443,734876,600135,134741,495772,227646,268126,734876,117266,139214,147398,117746,269735,78013,77321,114401,-4,19,31,11,-1,-2,21,5,-5,-10,54,0,20
2018,PA,7,140813,114437,263261,0,r,552078,267694,284384,731168,592545,138623,506292,149644,356648,731168,121337,133514,149302,130877,272827,107527,84678,80622,-4,19,31,11,-1,-2,21,5,-5,-10,53,0,19
2018,PA,8,135603,112563,248166,0,r,535133,261619,273514,696956,602185,94771,496882,124343,372539,696956,104550,125530,150565,136309,273634,124834,88771,60029,-4,19,31,11,-1,-2,21,5,-5,-10,55,0,19
2018,PA,9,100204,148723,248927,0,r,555775,277295,278480,702489,643082,59407,501251,107989,393262,702489,103624,128463,153496,140541,278703,120558,91581,66564,-4,19,31,11,-1,-2,21,5,-5,-10,53,0,19
2018,RI,1,116099,57567,174083,1,d,395409,188916,206493,532590,407075,125515,373209,125510,247699,532590,93511,98918,106763,92707,204598,88584,57580,58434,-4,19,31,11,-1,-2,21,5,-5,-10,54,0,20
2018,RI,2,126476,72271,199197,1,d,407668,195852,211816,524725,445730,78995,367486,129151,238335,524725,93948,94221,111797,89938,201975,70564,62216,69195,-4,19,31,11,-1,-2,21,5,-5,-10,53,0,20
2018,SC,1,145455,141473,287433,0,r,613912,295032,318880,809610,596258,213352,572743,234662,338081,809610,140152,155710,156504,147364,309161,106528,103728,98905,-4,19,31,11,-1,-2,21,5,-5,-10,69,0,19
2018,SC,2,109199,144642,257139,1,r,537342,255658,281684,717231,494348,222883,484174,158273,325901,717231,118523,135456,141580,116090,278823,118984,90794,69045,-4,19,31,11,-1,-2,21,5,-5,-10,71,0,19
2018,SC,3,70046,153338,226204,1,r,534772,258621,276151,697467,534791,162676,475701,109047,366654,697467,105346,127837,139047,130586,269147,138424,79868,50855,-4,19,31,11,-1,-2,21,5,-5,-10,71,0,19
2018,SC,4,89182,145321,243950,0,r,533533,251842,281691,736750,536500,200250,501213,164208,337005,736750,132592,136881,142829,117625,276650,118779,94150,63721,-4,19,31,11,-1,-2,21,5,-5,-10,67,0,19
2018,SC,5,103129,141757,248579,0,r,552247,262084,290163,731341,494957,236384,499678,122796,376882,731341,107779,144982,145326,123080,272378,130791,83279,58308,-4,19,31,11,-1,-2,21,5,-5,-10,74,0,18
2018,SC,6,144765,58282,206433,0,d,506843,241997,264846,659483,256307,403176,435567,88045,347522,659483,128014,114793,118196,104369,244616,151323,66867,26426,-4,19,31,11,-1,-2,21,5,-5,-10,77,0,19
2018,SC,7,96564,142681,239554,1,r,571428,265082,306346,732245,494545,237700,523279,112304,410975,732245,103551,126206,152894,160640,277216,152102,79889,45225,-4,19,31,11,-1,-2,21,5,-5,-10,74,0,19
2018,SD,1,120816,202446,335471,0,r,647089,323519,323570,882235,740870,141365,582850,170398,412452,882235,148304,153798,166393,146358,345449,153991,116501,74957,-4,19,31,11,-1,-2,21,5,-5,-10,57,0,18
2018,TN,1,47138,172835,224282,0,r,563918,271986,291932,720358,677690,42668,518074,106450,411624,720358,104019,135661,152846,148230,288541,159315,85503,43723,-4,19,31,11,-1,-2,21,5,-5,-10,57,0,19
2018,TN,2,86668,172856,262134,0,r,583056,278806,304250,753229,669804,83425,518808,161441,357367,753229,130132,139782,149309,135135,296678,135799,93501,67378,-4,19,31,11,-1,-2,21,5,-5,-10,63,0,20
2018,TN,3,84731,156512,245765,0,r,571456,274322,297134,736889,625434,111455,521055,124402,396653,736889,117062,137630,154064,137889,288674,140394,88557,59723,-4,19,31,11,-1,-2,21,5,-5,-10,68,0,19
2018,TN,4,78065,147323,232451,1,r,590540,284223,306317,798482,664963,133519,534925,120708,414217,798482,140251,153952,155361,118257,292287,132345,102837,57105,-4,19,31,11,-1,-2,21,5,-5,-10,64,0,18
2018,TN,5,177923,84317,262248,1,d,563797,267201,296596,777696,514933,262763,539992,214383,325609,777696,184469,153213,138623,97098,313581,128388,101794,83399,-4,19,31,11,-1,-2,21,5,-5,-10,67,0,19
2018,TN,6,70370,172810,248740,0,r,591603,286118,305485,784725,707579,77146,542312,125912,416400,784725,119063,150045,159820,138856,301779,131523,98209,72047,-4,19,31,11,-1,-2,21,5,-5,-10,61,0,19
2018,TN,7,81661,170071,254384,0,r,578288,283131,295157,786523,656918,129605,523215,168073,355142,786523,126502,156205,149844,116325,283079,123521,81006,78552,-4,19,31,11,-1,-2,21,5,-5,-10,66,0,19
2018,TN,8,74755,168030,248345,1,r,525277,252231,273046,699385,530025,169360,479656,138103,341553,699385,99241,131792,144463,124434,264635,119057,79762,65816,-4,19,31,11,-1,-2,21,5,-5,-10,72,0,20
2018,TN,9,145139,34901,181476,1,d,507231,229788,277443,712723,188242,524481,462786,115953,346833,712723,150927,130137,128493,88573,273886,164073,69307,40506,-4,19,31,11,-1,-2,21,5,-5,-10,76,0,19
2018,TX,1,61263,168165,232720,1,r,511974,243891,268083,725555,562287,163268,469993,100204,369789,725555,116250,128794,131162,120273,250860,121578,74787,54495,-4,19,31,11,-1,-2,21,5,-5,-10,60,0,18
2018,TX,10,144034,157166,307827,1,r,593629,288737,304892,896798,635232,261566,596203,251832,344371,896798,158543,188099,160420,115433,312919,97538,89695,125686,-4,19,31,11,-1,-2,21,5,-5,-10,52,0,19
2018,TX,11,40631,176603,220377,0,r,542570,270606,271964,782337,676504,105833,506456,111393,395063,782337,143910,134370,136759,123087,279550,118749,87155,73646,-4,19,31,11,-1,-2,21,5,-5,-10,45,0,18
2018,TX,12,90994,172557,268491,1,r,572411,275420,296991,812102,643801,168301,540691,173253,367438,812102,153214,159629,153810,105145,295792,104500,96291,95001,-4,19,31,11,-1,-2,21,5,-5,-10,52,0,18
2018,TX,13,35083,169027,207285,1,r,493390,251525,241865,711672,606114,105558,464036,101290,362746,711672,118629,129827,131924,108808,255984,123411,79200,53373,-4,19,31,11,-1,-2,21,5,-5,-10,48,0,18
2018,TX,14,92212,138942,234528,0,r,532153,266577,265576,763380,541303,222077,512141,130410,381731,763380,134586,149813,148250,106186,266981,108909,76798,81274,-4,19,31,11,-1,-2,21,5,-5,-10,58,0,18
2018,TX,15,98333,63862,164802,1,d,435170,216790,218380,795511,682610,112901,465558,97665,367893,795511,140834,148548,120184,85941,226062,117954,63844,44264,-4,19,31,11,-1,-2,21,5,-5,-10,41,0,18
2018,TX,16,124437,49127,181754,0,d,458940,227861,231079,733764,574519,159245,453426,115927,337499,733764,151425,132003,116764,91704,241212,131164,66884,43164,-4,19,31,11,-1,-2,21,5,-5,-10,42,0,19
2018,TX,17,98070,134841,237351,1,r,550601,266019,284582,793513,615999,177514,487941,157094,330847,793513,171436,143829,124582,98336,287547,133225,87517,66805,-4,19,31,11,-1,-2,21,5,-5,-10,54,0,19
2018,TX,18,138704,38368,184332,1,d,480387,233867,246520,801885,388019,413866,513574,125318,388256,801885,177850,158013,132363,76522,274598,142216,76263,56119,-4,19,31,11,-1,-2,21,5,-5,-10,58,0,19
2018,TX,19,50039,151946,201985,1,r,509891,253073,256818,731759,601004,130755,448078,104350,343728,731759,139547,129741,119079,100356,259000,130760,75438,52802,-4,19,31,11,-1,-2,21,5,-5,-10,47,0,18
2018,TX,2,119992,139188,263392,0,r,520180,252870,267310,803041,530501,272540,538093,227943,310150,803041,155219,169712,139522,95769,286897,94890,77540,114467,-4,19,31,11,-1,-2,21,5,-5,-10,52,0,19
2018,TX,20,139038,0,171963,1,d,549483,266701,282782,846337,698825,147512,520394,128707,391687,846337,181824,158621,126656,93978,257032,125162,80429,51441,-4,19,31,11,-1,-2,21,5,-5,-10,43,0,19
2018,TX,21,168421,177654,353617,0,r,622228,300234,321994,818281,695090,123191,574888,269256,305632,818281,167650,155529,156137,131351,326090,116459,96714,112917,-4,19,31,11,-1,-2,21,5,-5,-10,47,0,19
2018,TX,22,138153,152750,297405,1,r,577164,283653,293511,935386,557965,377421,604172,273177,330995,935386,147019,209663,172292,104393,301036,80931,85833,134272,-4,19,31,11,-1,-2,21,5,-5,-10,54,0,19
2018,TX,23,102359,103285,210069,1,r,507547,255762,251785,794879,667536,127343,505279,110320,394959,794879,138009,152247,134263,105863,243042,114393,71475,57174,-4,19,31,11,-1,-2,21,5,-5,-10,42,0,19
2018,TX,24,125231,133317,263418,0,r,503766,241559,262207,817147,512935,304212,561593,265027,296566,817147,173715,178186,151561,91697,318936,97868,103926,117142,-4,19,31,11,-1,-2,21,5,-5,-10,54,0,19
2018,TX,25,136385,163023,304553,1,r,570238,286160,284078,786976,637401,149575,525564,208852,316712,786976,128515,163746,142789,115659,279481,97098,81171,101212,-4,19,31,11,-1,-2,21,5,-5,-10,53,0,20
2018,TX,26,121938,185551,312505,1,r,605249,293998,311251,894192,681208,212984,578988,267950,311038,894192,157160,198087,164657,90210,299529,71378,87703,140448,-4,19,31,11,-1,-2,21,5,-5,-10,54,0,18
2018,TX,27,75929,125118,207421,0,r,517267,249089,268178,739719,632962,106757,487846,97492,390354,739719,121529,135356,135571,118955,259967,120231,80363,59373,-4,19,31,11,-1,-2,21,5,-5,-10,44,0,18
2018,TX,28,117494,0,139226,1,d,434305,211486,222819,768719,682000,86719,450652,85231,365421,768719,130645,141222,121156,89807,218960,115224,63539,40197,-4,19,31,11,-1,-2,21,5,-5,-10,42,0,18
2018,TX,29,88188,28098,117494,0,d,369239,184052,185187,765435,558932,206503,454240,47525,406715,765435,151632,152869,121282,64441,226787,124232,68847,33708,-4,19,31,11,-1,-2,21,5,-5,-10,44,0,18
2018,TX,3,138234,169520,312511,0,r,563318,267900,295418,899784,604718,295066,594844,324288,270556,899784,146404,209982,168777,101408,313568,75702,85749,152117,-4,19,31,11,-1,-2,21,5,-5,-10,56,0,19
2018,TX,30,166784,0,183174,1,d,479082,226629,252453,804679,404535,400144,499709,103493,396216,804679,158538,151720,137225,86687,270339,136664,82260,51415,-4,19,31,11,-1,-2,21,5,-5,-10,61,0,18
2018,TX,31,136362,144680,286007,0,r,602236,291279,310957,883347,658842,224505,573867,211323,362544,883347,164212,189144,148298,106381,296458,95738,97599,103121,-4,19,31,11,-1,-2,21,5,-5,-10,54,0,19
2018,TX,32,144067,126101,275620,1,r,505867,241389,264478,769852,519270,250582,526585,238248,288337,769852,168821,150537,146346,95901,292242,92058,87230,112954,-4,19,31,11,-1,-2,21,5,-5,-10,54,0,19
2018,TX,33,90805,26120,119224,0,d,360226,177253,182973,777745,461990,315755,454514,49741,404773,777745,153507,150388,117307,68640,231388,128998,75081,27309,-4,19,31,11,-1,-2,21,5,-5,-10,48,0,17
2018,TX,34,85825,57243,143068,0,d,424863,210491,214372,727688,671012,56676,435047,69518,365529,727688,112193,134876,114088,101984,213973,124869,57867,31237,-4,19,31,11,-1,-2,21,5,-5,-10,40,0,18
2018,TX,35,138278,50553,194067,1,d,532967,267072,265895,818369,604156,214213,532670,117438,415232,818369,197400,165587,132355,83304,280171,140330,88929,50912,-4,19,31,11,-1,-2,21,5,-5,-10,45,0,17
2018,TX,36,60908,161048,221956,1,r,519385,256534,262851,754178,619921,134257,489697,92481,397216,754178,124634,141574,142979,111382,259388,109176,79016,71196,-4,19,31,11,-1,-2,21,5,-5,-10,52,0,18
2018,TX,4,57400,188667,249245,1,r,543354,264225,279129,759648,613711,145937,509383,119650,389733,759648,111022,147702,147378,126918,272905,122310,82111,68484,-4,19,31,11,-1,-2,21,5,-5,-10,58,0,18
2018,TX,5,78666,130617,209507,0,r,480610,237717,242893,749808,564747,185061,489320,101661,387659,749808,128401,150493,131985,103839,259085,123391,79352,56342,-4,19,31,11,-1,-2,21,5,-5,-10,55,0,19
2018,TX,6,116350,135961,256042,0,r,554709,265398,289311,804816,516702,288114,519632,157895,361737,804816,142600,167335,145718,93745,272878,91021,90344,91513,-4,19,31,11,-1,-2,21,5,-5,-10,60,0,18
2018,TX,7,127959,115642,243601,0,r,448262,209156,239106,775198,484785,290413,512493,255141,257352,775198,156729,167227,138905,84625,286616,95882,86827,103907,-4,19,31,11,-1,-2,21,5,-5,-10,54,0,20
2018,TX,8,67930,200619,273170,1,r,584039,292242,291797,871420,726274,145146,576805,187354,389451,871420,141470,178172,166359,120514,294523,103998,83332,107193,-4,19,31,11,-1,-2,21,5,-5,-10,51,0,18
2018,TX,9,136256,0,153001,1,d,445634,211591,234043,786925,265656,521269,502725,122330,380395,786925,173886,163473,130504,80357,264287,136020,80984,47283,-4,19,31,11,-1,-2,21,5,-5,-10,59,0,19
2018,UT,1,63308,156692,254333,1,r,521517,261025,260492,776910,702001,74909,455801,145532,310269,776910,145632,148235,118870,82802,244538,79211,91218,74109,-4,19,31,11,-1,-2,21,5,-5,-10,46,0,18
2018,UT,2,105051,151489,270044,1,r,529608,266242,263366,779772,644977,134795,486080,164818,321262,779772,153600,144687,118117,104260,264379,103888,87300,73191,-4,19,31,11,-1,-2,21,5,-5,-10,45,0,19
2018,UT,3,70686,174856,258858,0,r,517848,257021,260827,773622,692923,80699,429142,182376,246766,773622,164603,132505,108262,85042,234958,74595,77413,82950,-4,19,31,11,-1,-2,21,5,-5,-10,46,0,19
2018,UT,4,134964,134270,269271,1,r,518368,257209,261159,830801,668294,162507,500879,159719,341160,830801,165530,172041,114543,79193,255016,71933,92301,90782,-4,19,31,11,-1,-2,21,5,-5,-10,46,0,18
2018,VA,1,148464,183250,332101,0,r,590281,288174,302107,813878,586080,227798,547095,206336,340759,813878,132036,158522,163238,123912,282681,69664,87061,125956,-4,19,31,11,-1,-2,21,5,-5,-10,63,0,19
2018,VA,10,206356,160841,367795,0,r,565197,278318,286879,862308,592714,269594,568968,321362,247606,862308,120742,196901,170571,108403,285017,47468,63237,174312,-4,19,31,11,-1,-2,21,5,-5,-10,55,0,21
2018,VA,11,219191,83023,308250,0,d,509988,252893,257095,798464,454640,343824,533861,298311,235550,798464,142945,172770,152701,95835,268471,51631,68002,148838,-4,19,31,11,-1,-2,21,5,-5,-10,56,0,21
2018,VA,2,139571,133458,273400,1,r,559397,278026,281371,743410,491633,251777,501425,185265,316160,743410,157676,134810,136401,112245,279178,93810,94418,90950,-4,19,31,11,-1,-2,21,5,-5,-10,66,0,20
2018,VA,3,198615,0,217722,1,d,559137,265323,293814,744804,330195,414609,493273,135616,357657,744804,156229,134204,136588,100426,290156,134895,93775,61486,-4,19,31,11,-1,-2,21,5,-5,-10,74,0,19
2018,VA,4,187642,107706,299854,1,d,579606,277950,301656,747291,395229,352062,525773,157719,368054,747291,142017,144151,152118,115128,283821,123096,83991,76734,-4,19,31,11,-1,-2,21,5,-5,-10,75,0,19
2018,VA,5,145040,165339,310926,0,r,578531,277524,301007,739410,554054,185356,520191,153190,367001,739410,109113,131623,153781,150340,290897,131989,89482,69426,-4,19,31,11,-1,-2,21,5,-5,-10,73,0,20
2018,VA,6,113133,167957,281377,0,r,582756,278155,304601,755437,624793,130644,511025,143196,367829,755437,118991,129654,148862,141158,290904,138314,89373,63217,-4,19,31,11,-1,-2,21,5,-5,-10,66,0,19
2018,VA,7,176079,169295,349803,0,r,588061,278885,309176,812385,563699,248686,554613,224663,329950,812385,129566,163545,161852,128234,296940,91954,93480,111506,-4,19,31,11,-1,-2,21,5,-5,-10,67,0,19
2018,VA,8,247137,76899,324748,0,d,533417,259240,274177,795467,503803,291664,569877,359099,210778,795467,185505,184061,138588,96724,324141,66003,79863,178275,-4,19,31,11,-1,-2,21,5,-5,-10,58,0,22
2018,VA,9,85833,160933,246980,1,r,567315,281110,286205,704831,640740,64091,495906,105700,390206,704831,108408,122170,146478,145820,283318,163027,81029,39262,-4,19,31,11,-1,-2,21,5,-5,-10,67,0,20
2018,VT,1,188547,70705,272451,1,d,500274,244517,255757,626299,589337,36962,445824,172589,273235,626299,96444,110460,136430,123875,261373,105889,86955,68529,-4,19,31,11,-1,-2,21,5,-5,-10,57,0,20
2018,WA,1,197209,135534,332743,0,d,519555,259298,260257,768363,594158,174205,535951,231112,304839,768363,131411,167192,155003,101663,281173,61347,77441,142385,-4,19,31,11,-1,-2,21,5,-5,-10,52,0,19
2018,WA,10,166215,103860,270075,1,d,544552,269010,275542,756028,544535,211493,507247,156060,351187,756028,155306,141066,133761,110809,278001,95142,96038,86821,-4,19,31,11,-1,-2,21,5,-5,-10,57,0,19
2018,WA,2,210187,0,294833,1,d,558321,277303,281018,755546,572849,182697,528182,175586,352596,755546,153225,142876,146220,125330,294886,100469,97889,96528,-4,19,31,11,-1,-2,21,5,-5,-10,52,0,19
2018,WA,3,145407,161819,307226,1,r,544994,267783,277211,743322,638152,105170,514865,139021,375844,743322,118382,142742,148908,128758,283318,103302,91820,88196,-4,19,31,11,-1,-2,21,5,-5,-10,50,0,19
2018,WA,4,83785,141551,225336,1,r,443137,219857,223280,735031,552489,182542,458340,99364,358976,735031,126968,131017,122752,103987,247728,106363,84005,57360,-4,19,31,11,-1,-2,21,5,-5,-10,42,0,19
2018,WA,5,144925,175422,320347,1,r,551532,270788,280744,725964,631506,94458,490017,148980,341037,725964,131683,125919,136986,125841,287768,130200,93766,63802,-4,19,31,11,-1,-2,21,5,-5,-10,52,0,19
2018,WA,6,206409,116677,323086,1,d,570991,286913,284078,731742,592326,139416,529215,168500,360715,731742,130802,132257,148863,147594,293137,106548,95881,90708,-4,19,31,11,-1,-2,21,5,-5,-10,55,0,20
2018,WA,7,329800,64881,394681,1,d,600321,299820,300501,799589,579901,219688,596853,372785,224068,799589,219291,169774,133067,114120,362118,97932,92724,171462,-4,19,31,11,-1,-2,21,5,-5,-10,55,0,20
2018,WA,8,164089,148968,313057,0,r,522952,255555,267397,754721,560125,194596,514614,187030,327584,754721,113660,155951,161313,102853,280830,76705,81981,122144,-4,19,31,11,-1,-2,21,5,-5,-10,52,0,19
2018,WA,9,240567,0,240567,1,d,499184,249316,249868,765285,367222,398063,539779,234666,305113,765285,164678,162992,139043,103032,286616,80073,84636,121907,-4,19,31,11,-1,-2,21,5,-5,-10,57,0,19
2018,WI,1,137508,177492,325317,0,r,539789,265317,274472,717716,628476,89240,498859,142232,356627,717716,106811,140540,156710,118576,279217,103296,91617,84304,-4,19,31,11,-1,-2,21,5,-5,-10,56,0,19
2018,WI,2,309116,0,317295,1,d,577976,282335,295641,768067,660542,107525,517064,217256,299808,768067,158110,143680,144188,115716,319184,116430,103672,99082,-4,19,31,11,-1,-2,21,5,-5,-10,57,0,20
2018,WI,3,187888,126980,314989,1,d,566700,282813,283887,724568,674388,50180,483062,125133,357929,724568,122549,123619,144775,129906,292708,125598,103515,63595,-4,19,31,11,-1,-2,21,5,-5,-10,55,0,18
2018,WI,4,206487,59091,273087,0,d,493143,231471,261672,710573,351094,359479,454996,129860,325136,710573,147772,129760,120602,86994,281405,153268,79293,48844,-4,19,31,11,-1,-2,21,5,-5,-10,66,0,20
2018,WI,5,138385,225619,364288,0,r,558805,269326,289479,731341,659846,71495,517004,200359,316645,731341,115604,139973,154311,132502,297562,103012,93821,100729,-4,19,31,11,-1,-2,21,5,-5,-10,54,0,19
2018,WI,6,144536,180311,325065,1,r,556485,279627,276858,714886,660186,54700,503751,128682,375069,714886,111959,131689,155207,132131,294811,122196,102921,69694,-4,19,31,11,-1,-2,21,5,-5,-10,55,0,18
2018,WI,7,124307,194061,322840,1,r,552651,276779,275872,710420,660634,49786,507276,119774,387502,710420,98076,127723,161369,144611,305764,134140,104373,67251,-4,19,31,11,-1,-2,21,5,-5,-10,54,0,18
2018,WI,8,119265,209410,328774,1,r,556205,275043,281162,735997,662077,73920,510010,134780,375230,735997,113631,138869,156756,126047,301309,119326,106214,75769,-4,19,31,11,-1,-2,21,5,-5,-10,53,0,18
2018,WV,1,70217,127997,198214,0,r,486327,240272,246055,606136,569483,36653,427206,104356,322850,606136,99608,109774,122536,120219,244052,128477,69178,46397,-4,19,31,11,-1,-2,21,5,-5,-10,67,0,20
2018,WV,2,88011,110504,204792,0,r,487208,238345,248863,624120,571744,52376,443180,96289,346891,624120,93227,117448,132077,120355,251791,128884,70022,52885,-4,19,31,11,-1,-2,21,5,-5,-10,68,0,19
2018,WV,3,76340,98645,174985,0,r,457623,222773,234850,575576,538546,37030,410395,72458,337937,575576,81241,108135,120592,120642,238860,148425,61939,28496,-4,19,31,11,-1,-2,21,5,-5,-10,72,0,20
2018,WY,1,59903,127963,201245,1,r,433644,219788,213856,577737,528453,49284,393136,105583,287553,577737,92595,106148,113176,96557,230252,94275,73899,62078,-4,19,31,11,-1,-2,21,5,-5,-10,46,0,19
2020,AK,1,159856,192126,351982,1,r,533151,278479,254672,731545,469771,261774,484058,146157,337901,731545,146429,136878,138613,90588,252199,79732,79580,92887,-9,20,15,9,-11,12,19,-7,12,-10,35,-3,0
2020,AL,1,116949,211825,328774,0,r,546223,256090,290133,717438,479955,237483,498018,124331,373687,717438,116057,132466,141726,131151,268033,132125,79027,56881,-9,20,15,9,-11,12,19,-7,12,-10,35,-3,0
2020,AL,2,105286,197996,303282,0,r,513747,242695,271052,674920,424115,250805,462069,108596,353473,674920,118083,122977,126902,120333,262180,129415,80050,52715,-9,20,15,9,-11,12,19,-7,12,-10,35,-3,0
2020,AL,3,104595,217384,321979,1,r,550776,262424,288352,717896,494456,223440,485973,116391,369582,717896,119363,133923,141058,119892,279236,134234,83774,61228,-9,20,15,9,-11,12,19,-7,12,-10,35,-3,0
2020,AL,4,56237,261553,317790,1,r,516456,251669,264787,687453,596835,90618,478734,83955,394779,687453,110248,127267,137767,128597,262865,137202,79184,46479,-9,20,15,9,-11,12,19,-7,12,-10,35,-3,0
2020,AL,5,0,0,0,1,r,563216,270465,292751,735858,552016,183842,508746,170191,338555,735858,121832,139509,149933,125778,293146,126358,83127,83661,-9,20,15,9,-11,12,19,-7,12,-10,35,-3,0
2020,AL,6,0,0,0,1,r,527401,250944,276457,699605,549842,149763,485802,186850,298952,699605,113889,140239,137508,115770,272470,98360,82158,91952,-9,20,15,9,-11,12,19,-7,12,-10,35,-3,0
2020,AL,7,0,0,0,1,d,513517,234099,279418,670015,229156,440859,440716,95043,345673,670015,116258,114051,123012,112791,259646,158240,62448,38958,-9,20,15,9,-11,12,19,-7,12,-10,35,-3,0
2020,AR,1,0,0,0,1,r,548521,268993,279528,719048,556680,162368,495994,80300,415694,719048,115210,134021,139651,132342,283256,158327,81384,43545,-9,20,15,9,-11,12,19,-7,12,-10,35,-3,0
2020,AR,2,148410,184093,332503,1,r,576874,271823,305051,767662,543432,224230,516846,152575,364271,767662,136289,143819,141722,128252,298841,140054,90613,68174,-9,20,15,9,-11,12,19,-7,12,-10,35,-3,0
2020,AR,3,106325,214960,334262,1,r,579984,280459,299525,829149,695183,133966,540537,156976,383561,829149,148396,155949,144686,125002,310011,142933,94087,72991,-9,20,15,9,-11,12,19,-7,12,-10,35,-3,0
2020,AR,4,75750,191617,275035,1,r,530036,254487,275549,701945,519725,182220,483079,85516,397563,701945,100112,124586,141181,138641,271539,150451,80466,40622,-9,20,15,9,-11,12,19,-7,12,-10,35,-3,0
2020,AZ,1,188469,176709,365178,1,d,579140,291634,287506,782088,502033,280055,523114,131695,391419,782088,120303,133571,139093,154809,273698,122754,85587,65357,-9,20,15,9,-11,12,19,-7,12,-10,35,-3,0
2020,AZ,2,209945,170975,380920,1,d,555917,274252,281665,733197,599844,133353,520648,183906,336742,733197,138465,125582,134482,163401,309633,143579,88879,77175,-9,20,15,9,-11,12,19,-7,12,-10,35,-3,0
2020,AZ,3,174243,95594,269837,1,d,498408,252613,245795,801531,596963,204568,487229,80782,406447,801531,154745,141690,128151,97382,248829,113250,87770,47809,-9,20,15,9,-11,12,19,-7,12,-10,35,-3,0
2020,AZ,4,120484,278002,398486,1,r,646034,326716,319318,825763,725078,100685,614211,128727,485484,825763,106414,130375,167166,231593,329367,147928,113447,67992,-9,20,15,9,-11,12,19,-7,12,-10,35,-3,0
2020,AZ,5,183171,262414,445585,1,r,601179,292353,308826,849917,704936,144981,566847,216821,350026,849917,122866,171308,154394,146847,300867,79863,97056,123948,-9,20,15,9,-11,12,19,-7,12,-10,35,-3,0
2020,AZ,6,199644,217783,417427,1,r,603700,290624,313076,814971,673502,141469,599072,260864,338208,814971,140129,147591,177565,162366,333370,107550,96987,128833,-9,20,15,9,-11,12,19,-7,12,-10,35,-3,0
2020,AZ,7,165452,50226,215678,1,d,472749,233447,239302,853856,622724,231132,510459,80871,429588,853856,170825,173022,130031,72596,258353,131408,84379,42566,-9,20,15,9,-11,12,19,-7,12,-10,35,-3,0
2020,AZ,8,0,422449,422449,1,r,595539,280767,314772,798544,661387,137157,569334,179470,389864,798544,117137,144796,150256,178500,293215,94293,101298,97624,-9,20,15,9,-11,12,19,-7,12,-10,35,-3,0
2020,AZ,9,217094,135180,352274,1,d,584808,291525,293283,818850,615343,203507,553626,229022,324604,818850,217059,157137,129492,99747,323109,123497,101085,98527,-9,20,15,9,-11,12,19,-7,12,-10,35,-3,0
2020,CA,1,154073,204190,358263,1,r,548314,275328,272986,711905,603558,108347,502634,129725,372909,711905,115757,121497,138546,151727,271323,116132,80258,74933,-9,20,15,9,-11,12,19,-7,12,-10,35,-3,0
2020,CA,10,166865,135629,302494,1,d,491086,239035,252051,764859,586647,178212,489271,88280,400991,764859,137220,146119,135370,98959,238915,83533,76986,78396,-9,20,15,9,-11,12,19,-7,12,-10,35,-3,0
2020,CA,11,271063,100293,371356,1,d,502739,243068,259671,765504,413527,351977,535458,239756,295702,765504,128118,153904,154443,127054,268492,61135,66802,140555,-9,20,15,9,-11,12,19,-7,12,-10,35,-3,0
2020,CA,12,362950,0,362950,1,d,584273,296492,287781,779824,365775,414049,624292,380139,244153,779824,215803,180105,135673,121453,331958,79880,58970,193108,-9,20,15,9,-11,12,19,-7,12,-10,35,-3,0
2020,CA,13,327863,34955,362818,1,d,541697,256790,284907,768889,312008,456881,553531,297776,255755,768889,174871,162501,132677,113382,294896,91087,66565,137244,-9,20,15,9,-11,12,19,-7,12,-10,35,-3,0
2020,CA,14,278227,72684,350911,1,d,501803,242363,259440,742980,324124,418856,545305,270049,275256,742980,144362,153617,148912,126778,255130,49314,51184,154632,-9,20,15,9,-11,12,19,-7,12,-10,35,-3,0
2020,CA,15,242991,99710,342701,1,d,502500,249505,252995,782312,320614,461698,550420,264365,286055,782312,129712,178360,154755,111508,254639,42748,57470,154421,-9,20,15,9,-11,12,19,-7,12,-10,35,-3,0
2020,CA,16,128690,88039,216729,1,d,423209,204465,218744,753152,421820,331332,449986,59589,390397,753152,147222,138298,110737,83510,217249,107788,64226,45235,-9,20,15,9,-11,12,19,-7,12,-10,35,-3,0
2020,CA,17,212137,85199,297336,1,d,454565,232883,221682,790519,218288,572231,572018,344105,227913,790519,181964,175498,148752,93986,264673,37660,47809,179204,-9,20,15,9,-11,12,19,-7,12,-10,35,-3,0
2020,CA,18,344127,0,344127,1,d,486648,235472,251176,753806,471578,282228,528134,347460,180674,753806,122010,160426,147576,120278,271858,45599,50352,175907,-9,20,15,9,-11,12,19,-7,12,-10,35,-3,0
2020,CA,19,224385,88642,313027,1,d,470847,237269,233578,737535,346098,391437,508258,188749,319509,737535,147628,151076,137865,105031,228533,52499,53977,122057,-9,20,15,9,-11,12,19,-7,12,-10,35,-3,0
2020,CA,2,294435,0,388755,1,d,531039,258428,272611,708434,565797,142637,514776,219660,295116,708434,95560,130804,149991,157829,285860,95384,73329,117147,-9,20,15,9,-11,12,19,-7,12,-10,35,-3,0
2020,CA,20,236896,71658,308554,1,d,446278,221708,224570,741838,431723,310115,475688,141328,334360,741838,130290,138074,128746,108553,231132,72706,67410,91016,-9,20,15,9,-11,12,19,-7,12,-10,35,-3,0
2020,CA,21,84406,85928,170334,1,d,376921,199204,177717,729460,518642,210818,424849,45309,379540,729460,155176,131208,108312,66896,196617,105372,57817,33428,-9,20,15,9,-11,12,19,-7,12,-10,35,-3,0
2020,CA,22,0,315139,315139,1,r,485479,234418,251061,768917,507640,261277,477908,117316,360592,768917,146865,143925,122258,97370,250996,93647,79944,77405,-9,20,15,9,-11,12,19,-7,12,-10,35,-3,0
2020,CA,23,115896,190222,306118,1,r,499637,249899,249738,741557,535011,206546,482820,106779,376041,741557,135511,139223,129121,103683,247660,99798,69708,78154,-9,20,15,9,-11,12,19,-7,12,-10,35,-3,0
2020,CA,24,212564,149781,362345,1,d,510335,251419,258916,737443,592003,145440,476471,170179,306292,737443,135356,122616,128837,131583,257087,85502,74509,97076,-9,20,15,9,-11,12,19,-7,12,-10,35,-3,0
2020,CA,25,169305,169638,338943,1,r,490670,243942,246728,718949,482656,236293,469409,132514,336895,718949,113813,142986,145802,90980,221082,63477,65630,91975,-9,20,15,9,-11,12,19,-7,12,-10,35,-3,0
2020,CA,26,208856,135877,344733,1,d,483010,234217,248793,725535,588465,137070,491060,172760,318300,725535,125049,136250,139676,117788,227406,57004,66660,103742,-9,20,15,9,-11,12,19,-7,12,-10,35,-3,0
2020,CA,27,221411,95907,317318,1,d,482244,230040,252204,712783,272974,439809,524931,240756,284175,712783,130923,143905,148307,127025,243697,62252,71208,110237,-9,20,15,9,-11,12,19,-7,12,-10,35,-3,0
2020,CA,28,244271,91928,336199,1,d,489048,235707,253341,693299,465624,227675,541874,260580,281294,693299,161287,155965,135279,113816,295486,106948,76823,111715,-9,20,15,9,-11,12,19,-7,12,-10,35,-3,0
2020,CA,29,210944,0,210944,1,d,416537,202354,214183,717659,417841,299818,480197,107084,373113,717659,156060,149435,127467,82625,211871,87342,67064,57465,-9,20,15,9,-11,12,19,-7,12,-10,35,-3,0
2020,CA,3,176036,145941,321977,1,d,522479,260030,262449,755811,519095,236716,492041,133955,358086,755811,146163,138087,133360,112090,255155,86406,77638,91111,-9,20,15,9,-11,12,19,-7,12,-10,35,-3,0
2020,CA,30,240038,105426,345464,1,d,529032,252240,276792,764062,470231,293831,559906,253295,306611,764062,143675,163210,156751,123773,282925,81248,74528,127149,-9,20,15,9,-11,12,19,-7,12,-10,35,-3,0
2020,CA,31,175315,0,286050,1,d,498759,242379,256380,753576,455935,297641,491524,127349,364175,753576,155813,144117,130726,93180,229969,82513,71458,75998,-9,20,15,9,-11,12,19,-7,12,-10,35,-3,0
2020,CA,32,172942,86818,259760,1,d,456875,219113,237762,700726,352520,348206,485687,108463,377224,700726,130309,139939,136141,109428,202442,72873,62860,66709,-9,20,15,9,-11,12,19,-7,12,-10,35,-3,0
2020,CA,33,380428,0,380428,1,d,522362,249714,272648,703908,502404,201504,508984,338775,170209,703908,117673,138584,145073,127584,291655,62683,64231,164741,-9,20,15,9,-11,12,19,-7,12,-10,35,-3,0
2020,CA,34,205346,0,205346,1,d,416264,212162,204102,730042,253054,476988,518267,156820,361447,730042,193543,152155,120220,92617,257349,122699,72108,62542,-9,20,15,9,-11,12,19,-7,12,-10,35,-3,0
2020,CA,35,169405,74941,244346,1,d,455488,225264,230224,764643,398056,366587,485100,88534,396566,764643,157838,156553,125851,80097,201969,66009,70983,64977,-9,20,15,9,-11,12,19,-7,12,-10,35,-3,0
2020,CA,36,185051,121640,306691,1,d,538461,271336,267125,755764,538309,217455,542185,131204,410981,755764,119784,128008,142685,177405,277381,122266,77606,77509,-9,20,15,9,-11,12,19,-7,12,-10,35,-3,0
2020,CA,37,254916,41705,296621,1,d,475186,228843,246343,733668,368150,365518,518935,208812,310123,733668,181927,152345,127336,93744,275527,103386,69783,102358,-9,20,15,9,-11,12,19,-7,12,-10,35,-3,0
2020,CA,38,190467,65739,256206,1,d,475031,231474,243557,704515,291696,412819,485813,120710,365103,704515,136949,138406,132601,110625,203171,62955,61179,79037,-9,20,15,9,-11,12,19,-7,12,-10,35,-3,0
2020,CA,39,169837,173946,343783,1,d,486371,236734,249637,717176,372510,344666,504099,217032,287067,717176,124073,140989,150114,118795,229737,51213,67552,110972,-9,20,15,9,-11,12,19,-7,12,-10,35,-3,0
2020,CA,4,194731,247291,442022,1,r,577133,284329,292804,757806,639821,117985,552358,194582,357776,757806,100269,143515,162813,167912,286740,81605,83183,121952,-9,20,15,9,-11,12,19,-7,12,-10,35,-3,0
2020,CA,40,135572,50809,186381,1,d,334291,162998,171293,715934,398844,317090,432756,43534,389222,715934,140509,141279,117113,66358,179420,86420,57647,35353,-9,20,15,9,-11,12,19,-7,12,-10,35,-3,0
2020,CA,41,167938,94289,262227,1,d,479421,235656,243765,786719,366550,420169,477323,83925,393398,786719,158164,154098,125165,76051,195146,63101,70354,61691,-9,20,15,9,-11,12,19,-7,12,-10,35,-3,0
2020,CA,42,157667,210074,367741,1,r,565461,280586,284875,840562,513962,326600,546396,144918,401478,840562,148897,170153,153846,103475,236023,57565,69494,108964,-9,20,15,9,-11,12,19,-7,12,-10,35,-3,0
2020,CA,43,199210,78688,277898,1,d,451030,214518,236512,748092,324125,423967,508495,151188,357307,748092,161193,148706,135327,94166,246103,91518,72804,81781,-9,20,15,9,-11,12,19,-7,12,-10,35,-3,0
2020,CA,44,206036,0,206036,1,d,405957,192770,213187,717140,328279,388861,460026,68384,391642,717140,153707,133294,125177,84052,191030,78958,63573,48499,-9,20,15,9,-11,12,19,-7,12,-10,35,-3,0
2020,CA,45,221843,193096,414939,1,d,537433,258994,278439,791311,490112,301199,549853,310952,238901,791311,134986,157319,158602,123923,281965,58783,61977,161205,-9,20,15,9,-11,12,19,-7,12,-10,35,-3,0
2020,CA,46,157803,71716,229519,1,d,419462,209837,209625,734651,372328,362323,478516,101047,377469,734651,162116,149083,126068,78678,194502,59439,69694,65369,-9,20,15,9,-11,12,19,-7,12,-10,35,-3,0
2020,CA,47,197028,114371,311399,1,d,483829,237894,245935,717594,376564,341030,501717,171325,330392,717594,136594,148790,138978,105346,243994,85288,68143,90563,-9,20,15,9,-11,12,19,-7,12,-10,35,-3,0
2020,CA,48,193362,201738,395100,1,d,513819,247870,265949,718359,446054,272305,521323,232468,288855,718359,128788,139780,148356,129538,264799,64567,66600,133632,-9,20,15,9,-11,12,19,-7,12,-10,35,-3,0
2020,CA,49,205349,181157,386506,1,d,519217,256155,263062,731366,589795,141571,500886,236248,264638,731366,132304,138778,143797,119571,253903,62358,64523,127022,-9,20,15,9,-11,12,19,-7,12,-10,35,-3,0
2020,CA,5,271233,85227,356460,1,d,520065,250997,269068,726072,453790,272282,519390,172846,346544,726072,120434,139573,149187,136937,268680,73430,83559,111691,-9,20,15,9,-11,12,19,-7,12,-10,35,-3,0
2020,CA,50,166859,195510,362369,0,r,524595,264948,259647,758142,597572,160570,508173,156788,351385,758142,128823,141899,145673,119838,245557,78022,70852,96683,-9,20,15,9,-11,12,19,-7,12,-10,35,-3,0
2020,CA,51,165596,76841,242437,1,d,443525,233619,209906,740797,507815,232982,477722,75105,402617,740797,155223,142754,121223,91866,207851,98470,65414,43967,-9,20,15,9,-11,12,19,-7,12,-10,35,-3,0
2020,CA,52,244145,152350,396495,1,d,560713,284877,275836,767151,509171,257980,539667,329166,210501,767151,169272,148839,142504,112315,287694,63292,68853,155549,-9,20,15,9,-11,12,19,-7,12,-10,35,-3,0
2020,CA,53,334858,0,334858,0,d,564095,278952,285143,782599,490429,292170,551681,223471,328210,782599,185465,166853,129894,106022,276264,76939,91315,108010,-9,20,15,9,-11,12,19,-7,12,-10,35,-3,0
2020,CA,6,229648,83466,313114,1,d,519617,244641,274976,781943,387825,394118,514711,152479,362232,781943,170197,151192,125828,101267,281104,109306,87741,84057,-9,20,15,9,-11,12,19,-7,12,-10,35,-3,0
2020,CA,7,217416,166549,383965,1,d,537108,257950,279158,756668,457105,299563,531936,179445,352491,756668,131255,151211,153359,120243,272771,81358,86463,104950,-9,20,15,9,-11,12,19,-7,12,-10,35,-3,0
2020,CA,8,124400,158711,283111,0,r,473737,235671,238066,723311,534310,189001,448074,77719,370355,723311,132899,123718,127917,95280,228723,102639,73180,52904,-9,20,15,9,-11,12,19,-7,12,-10,35,-3,0
2020,CA,9,174252,128358,302610,1,d,506465,249492,256973,784956,416134,368822,505038,113687,391351,784956,134054,147285,139700,111008,241764,83709,71401,86654,-9,20,15,9,-11,12,19,-7,12,-10,35,-3,0
2020,CO,1,331621,105955,450290,1,d,635916,316403,319513,852816,669632,183184,621474,323866,297608,852816,222173,186963,136950,107618,368498,116003,107686,144809,-9,20,15,9,-11,12,19,-7,12,-10,35,-3,0
2020,CO,2,316925,182547,515663,1,d,639136,321508,317628,824050,743729,80321,563353,320574,242779,824050,158812,158734,161617,127699,333774,90158,98599,145017,-9,20,15,9,-11,12,19,-7,12,-10,35,-3,0
2020,CO,3,194122,220634,429319,0,r,571465,285677,285788,756569,676878,79691,534957,176426,358531,756569,120668,141859,148160,148022,303788,128781,96723,78284,-9,20,15,9,-11,12,19,-7,12,-10,35,-3,0
2020,CO,4,173945,285606,475107,1,r,618377,309567,308810,868302,773040,95262,582259,216613,365646,868302,143193,180434,165760,122785,318691,92396,96579,129716,-9,20,15,9,-11,12,19,-7,12,-10,35,-3,0
2020,CO,5,161600,249013,432407,1,r,618627,318636,299991,820255,663089,157166,553635,209028,344607,820255,169489,151320,151971,121423,305276,101963,104184,99129,-9,20,15,9,-11,12,19,-7,12,-10,35,-3,0
2020,CO,6,250314,175192,438473,1,d,569294,282862,286432,828201,605860,222341,559231,246226,313005,828201,154385,173972,155530,105716,301487,75832,94475,131180,-9,20,15,9,-11,12,19,-7,12,-10,35,-3,0
2020,CO,7,250525,159301,423691,1,d,591395,293995,297400,808543,690151,118392,560034,202869,357165,808543,170897,164418,144246,112115,303589,88152,101066,114371,-9,20,15,9,-11,12,19,-7,12,-10,35,-3,0
2020,CT,1,222668,122111,349237,1,d,519263,243906,275357,703138,476475,226663,497182,191701,305481,703138,119324,134272,145411,124354,280863,95875,80637,104351,-9,20,15,9,-11,12,19,-7,12,-10,35,-3,0
2020,CT,2,217982,140340,367172,1,d,548326,271760,276566,701590,604510,97080,493416,176861,316555,701590,114999,126308,153848,130457,278655,86724,83092,108839,-9,20,15,9,-11,12,19,-7,12,-10,35,-3,0
2020,CT,3,203265,137596,346101,1,d,545247,258201,287046,717989,513602,204387,508149,183269,324880,717989,125772,131659,153672,126141,279104,103117,80829,95158,-9,20,15,9,-11,12,19,-7,12,-10,35,-3,0
2020,CT,4,223832,130627,360115,1,d,487562,228970,258592,737733,533457,204276,499124,262496,236628,737733,107803,146509,153244,116413,263988,70236,58933,134819,-9,20,15,9,-11,12,19,-7,12,-10,35,-3,0
2020,CT,5,192484,151988,349524,1,d,519076,250870,268206,704837,532184,172653,498549,180221,318328,704837,114800,128500,149453,131667,274556,95860,73845,104851,-9,20,15,9,-11,12,19,-7,12,-10,35,-3,0
2020,DC,1,0,0,0,0,,536768,249106,287662,705749,300058,405691,505145,301429,203716,705749,192051,146151,107081,87537,291570,85655,67345,138570,-9,20,15,9,-11,12,19,-7,12,-10,35,-3,0
2020,DE,1,281382,196392,488270,1,d,725178,344221,380957,973764,659719,314045,687311,228199,459112,973764,158989,173039,196222,189638,376239,132511,120110,123618,-9,20,15,9,-11,12,19,-7,12,-10,35,-3,0
2020,FL,1,149172,283352,438562,1,r,606302,303884,302418,798305,610105,188200,553521,149161,404360,798305,150727,141547,157972,137233,293683,124881,94443,74359,-9,20,15,9,-11,12,19,-7,12,-10,35,-3,0
2020,FL,10,239434,136889,376323,1,d,535381,259125,276256,811634,439898,371736,555328,180883,374445,811634,172048,167959,153115,96590,262196,104776,89229,68191,-9,20,15,9,-11,12,19,-7,12,-10,35,-3,0
2020,FL,11,158094,316979,475073,1,r,669669,318953,350716,813112,703430,109682,640773,150297,490476,813112,86711,112294,153563,304733,340680,159707,117636,63337,-9,20,15,9,-11,12,19,-7,12,-10,35,-3,0
2020,FL,12,168194,284941,453135,1,r,625818,295093,330725,811308,700266,111042,600651,170386,430265,811308,106229,150214,165909,199092,315056,138809,96647,79600,-9,20,15,9,-11,12,19,-7,12,-10,35,-3,0
2020,FL,13,215405,190713,406118,1,d,585038,279918,305120,731658,577591,154067,564546,186344,378202,731658,119561,128069,167116,175833,297213,129474,92839,74900,-9,20,15,9,-11,12,19,-7,12,-10,35,-3,0
2020,FL,14,224240,147896,372136,1,d,571062,277670,293392,831508,570683,260825,569987,219270,350717,831508,169729,165607,155479,112150,309771,129561,94328,85882,-9,20,15,9,-11,12,19,-7,12,-10,35,-3,0
2020,FL,15,174297,216374,390671,0,r,580626,276725,303901,801294,592165,209129,562601,144897,417704,801294,139763,163070,154127,132043,279096,118991,93998,66107,-9,20,15,9,-11,12,19,-7,12,-10,35,-3,0
2020,FL,16,215683,269001,484684,1,r,665073,313756,351317,873875,718753,155122,655302,216890,438412,873875,115638,149076,175556,239901,332027,117655,110308,104064,-9,20,15,9,-11,12,19,-7,12,-10,35,-3,0
2020,FL,17,140487,266514,412397,1,r,635931,311152,324779,804754,689915,114839,616575,141617,474958,804754,96465,119272,159812,263863,310259,144038,100387,65834,-9,20,15,9,-11,12,19,-7,12,-10,35,-3,0
2020,FL,18,186674,253286,449720,1,r,604583,289422,315161,795742,633471,162271,594935,192253,402682,795742,111670,133145,164528,209875,304300,112483,91025,100792,-9,20,15,9,-11,12,19,-7,12,-10,35,-3,0
2020,FL,19,172146,272440,444586,0,r,637525,307253,330272,833013,707780,125233,644980,218098,426882,833013,106080,128392,162959,271415,321480,114785,103879,102816,-9,20,15,9,-11,12,19,-7,12,-10,35,-3,0
2020,FL,2,0,0,0,1,r,561491,281531,279960,720777,584919,135858,510536,125808,384728,720777,110260,128506,147059,149322,274771,125618,89584,59569,-9,20,15,9,-11,12,19,-7,12,-10,35,-3,0
2020,FL,20,253661,68748,322409,1,d,491860,233492,258368,802463,307837,494626,539949,112553,427396,802463,146489,157637,150393,112775,260511,131482,80693,48336,-9,20,15,9,-11,12,19,-7,12,-10,35,-3,0
2020,FL,21,237925,157612,403081,1,d,549008,260400,288608,786566,584990,201576,594312,220314,373998,786566,112422,140985,152296,211464,304170,117474,92151,94545,-9,20,15,9,-11,12,19,-7,12,-10,35,-3,0
2020,FL,22,235764,166553,402317,1,d,549615,270383,279232,760953,584725,176228,575156,239263,335893,760953,113913,145238,164059,170523,309545,112472,87439,109634,-9,20,15,9,-11,12,19,-7,12,-10,35,-3,0
2020,FL,23,221239,158874,380113,1,d,512459,238034,274425,762858,549287,213571,539304,219221,320083,762858,120218,158881,158528,129438,277260,101075,81955,94230,-9,20,15,9,-11,12,19,-7,12,-10,35,-3,0
2020,FL,24,218825,59084,289612,1,d,464185,220655,243530,754731,327064,427667,524113,106746,417367,754731,150174,152450,138863,111275,254252,141325,73327,39600,-9,20,15,9,-11,12,19,-7,12,-10,35,-3,0
2020,FL,25,0,0,0,1,r,466682,223166,243516,796422,720833,75589,573976,154294,419682,796422,127657,160002,163906,152001,252220,112746,79176,60298,-9,20,15,9,-11,12,19,-7,12,-10,35,-3,0
2020,FL,26,165407,177223,342630,1,d,481612,226439,255173,780951,634078,146873,541253,154279,386974,780951,124150,163142,158451,120774,235037,87145,81032,66860,-9,20,15,9,-11,12,19,-7,12,-10,35,-3,0
2020,FL,27,166758,176141,342899,1,d,457408,216811,240597,750653,642481,108172,559720,230169,329551,750653,137271,155176,151418,141941,287331,123688,74272,89371,-9,20,15,9,-11,12,19,-7,12,-10,35,-3,0
2020,FL,3,167326,223075,390401,0,r,579748,284160,295588,758939,566550,192389,512176,153927,358249,758939,142225,137647,143965,129947,279725,127206,84267,68252,-9,20,15,9,-11,12,19,-7,12,-10,35,-3,0
2020,FL,4,196423,308497,504920,1,r,625074,300144,324930,836235,665073,171162,591928,248005,343923,836235,144989,163041,166671,145084,317700,96977,101917,118806,-9,20,15,9,-11,12,19,-7,12,-10,35,-3,0
2020,FL,5,219463,117510,336973,1,d,553978,267413,286565,742643,330808,411835,488838,99588,389250,742643,163332,135224,133504,99694,281508,155740,85150,40618,-9,20,15,9,-11,12,19,-7,12,-10,35,-3,0
2020,FL,6,172305,265393,437698,1,r,630741,304518,326223,790455,629851,160604,592738,146936,445802,790455,109700,130335,170907,205083,310974,140099,102766,68109,-9,20,15,9,-11,12,19,-7,12,-10,35,-3,0
2020,FL,7,224946,175750,406449,1,d,609432,290108,319324,814980,602360,212620,563410,231714,331696,814980,166418,164174,146832,120022,301756,111977,97046,92733,-9,20,15,9,-11,12,19,-7,12,-10,35,-3,0
2020,FL,8,177695,282093,459788,1,r,615259,296340,318919,780036,645766,134270,586059,178673,407386,780036,109442,125508,171332,202175,299585,127752,94497,77336,-9,20,15,9,-11,12,19,-7,12,-10,35,-3,0
2020,FL,9,240724,188889,429613,1,d,641755,313030,328725,931872,689400,242472,631835,162051,469784,931872,162636,189765,163546,153952,293726,132170,101046,60510,-9,20,15,9,-11,12,19,-7,12,-10,35,-3,0
2020,GA,1,135238,189457,324695,1,r,559876,270072,289804,749949,465838,284111,499698,131353,368345,749949,137440,139689,133384,117423,276916,124022,91119,61775,-9,20,15,9,-11,12,19,-7,12,-10,35,-3,0
2020,GA,10,142636,235810,378446,1,r,563658,270780,292878,757807,511091,246716,494772,146351,348421,757807,119162,143817,141919,115450,271451,113471,83307,74673,-9,20,15,9,-11,12,19,-7,12,-10,35,-3,0
2020,GA,11,160623,245259,405882,1,r,552348,262987,289361,782704,557147,225557,533804,228693,305111,782704,143735,164212,150834,103970,299424,89092,100410,109922,-9,20,15,9,-11,12,19,-7,12,-10,35,-3,0
2020,GA,12,129061,181038,310099,1,r,547340,266484,280856,732810,426101,306709,477719,105825,371894,732810,131796,131316,133504,109893,247719,123205,76740,47774,-9,20,15,9,-11,12,19,-7,12,-10,35,-3,0
2020,GA,13,279045,81476,360521,1,d,550568,248997,301571,802943,232947,569996,515412,152794,362618,802943,142294,163799,149238,88652,273017,99531,94983,78503,-9,20,15,9,-11,12,19,-7,12,-10,35,-3,0
2020,GA,14,77798,229827,307625,0,r,525633,253881,271752,732133,619580,112553,488083,89991,398092,732133,115495,146779,142936,109847,259248,117412,86753,55083,-9,20,15,9,-11,12,19,-7,12,-10,35,-3,0
2020,GA,2,161397,111620,273017,1,d,502891,241466,261425,671831,279421,392410,444585,81951,362634,671831,110580,124826,124860,108029,244980,144524,63906,36550,-9,20,15,9,-11,12,19,-7,12,-10,35,-3,0
2020,GA,3,129792,241526,371318,1,r,554271,262564,291707,750998,515005,235993,504836,131437,373399,750998,121839,147073,146712,118110,271059,101161,91500,78398,-9,20,15,9,-11,12,19,-7,12,-10,35,-3,0
2020,GA,4,278906,69393,348299,1,d,533857,240183,293674,782142,213149,568993,520204,159888,360316,782142,140328,161033,149100,97664,271813,114332,90181,67300,-9,20,15,9,-11,12,19,-7,12,-10,35,-3,0
2020,GA,5,301857,52646,354503,0,d,596247,285104,311143,788996,274634,514362,540736,256244,284492,788996,197790,156054,128912,99009,328926,140129,87693,101104,-9,20,15,9,-11,12,19,-7,12,-10,35,-3,0
2020,GA,6,216775,180329,397104,1,d,502565,235838,266727,742932,495449,247483,517761,337231,180530,742932,123132,163884,153695,101012,297852,74360,74318,149174,-9,20,15,9,-11,12,19,-7,12,-10,35,-3,0
2020,GA,7,190900,180564,371464,0,r,501852,237683,264169,844773,433565,411208,544382,245165,299217,844773,135219,186784,158601,91360,273983,77748,85486,110749,-9,20,15,9,-11,12,19,-7,12,-10,35,-3,0
2020,GA,8,109264,198701,307965,1,r,522995,247242,275753,706237,433426,272811,468430,106301,362129,706237,123531,133646,128345,115415,263205,129576,79306,54323,-9,20,15,9,-11,12,19,-7,12,-10,35,-3,0
2020,GA,9,79797,292750,372547,0,r,567736,273343,294393,771168,674346,96822,529800,128344,401456,771168,117914,137524,155948,147358,273121,113558,89593,69970,-9,20,15,9,-11,12,19,-7,12,-10,35,-3,0
2020,HI,1,183245,71188,254433,1,d,518980,264407,254573,720786,120751,600035,516378,189577,326801,720786,141980,138577,129088,137647,243440,66530,72296,104614,-9,20,15,9,-11,12,19,-7,12,-10,35,-3,0
2020,HI,2,171517,84027,272102,0,d,495055,248164,246891,695086,220460,474626,480290,145632,334658,695086,112315,130645,133106,131823,221859,66388,68745,86726,-9,20,15,9,-11,12,19,-7,12,-10,35,-3,0
2020,IA,1,201347,212088,413435,1,d,581804,284599,297205,774014,700111,73903,522280,144188,378092,774014,124340,136001,150423,142348,314430,126398,107545,80487,-9,20,15,9,-11,12,19,-7,12,-10,35,-3,0
2020,IA,2,196958,196964,393922,0,d,589622,289765,299857,782989,693896,89093,528357,149821,378536,782989,135139,140172,150490,138580,316300,133626,103533,79141,-9,20,15,9,-11,12,19,-7,12,-10,35,-3,0
2020,IA,3,219205,212997,447563,1,d,614259,299126,315133,848170,748148,100022,569629,200426,369203,848170,146364,168783,154979,129257,342025,122559,113180,106286,-9,20,15,9,-11,12,19,-7,12,-10,35,-3,0
2020,IA,4,144761,237369,382130,0,r,563102,280817,282285,749897,693381,56516,502738,127818,374920,749897,119147,126363,141916,143390,314466,134800,108002,71664,-9,20,15,9,-11,12,19,-7,12,-10,35,-3,0
2020,ID,1,131309,310746,458490,1,r,682493,336247,346246,934826,828763,106063,629953,171209,458744,934826,147994,176651,174276,163779,341529,128732,125272,87525,-9,20,15,9,-11,12,19,-7,12,-10,35,-3,0
2020,ID,2,124151,250668,391332,1,r,600137,300167,299970,852239,768155,84084,541044,165446,375598,852239,159416,150326,146326,124838,314330,132716,103745,77869,-9,20,15,9,-11,12,19,-7,12,-10,35,-3,0
2020,IL,1,239943,85027,324970,1,d,525671,238027,287644,711039,298659,412380,487651,152800,334851,711039,130448,130665,139072,118540,271729,120071,75557,76101,-9,20,15,9,-11,12,19,-7,12,-10,35,-3,0
2020,IL,10,202402,114442,316844,1,d,469258,229089,240169,706189,486169,220020,472120,208701,263419,706189,107583,136345,140436,111625,253447,75122,69224,109101,-9,20,15,9,-11,12,19,-7,12,-10,35,-3,0
2020,IL,11,194557,112807,307364,1,d,478947,229453,249494,721594,498296,223298,474944,178266,296678,721594,122039,154284,136812,92511,250397,73418,77594,99385,-9,20,15,9,-11,12,19,-7,12,-10,35,-3,0
2020,IL,12,127577,194839,322416,1,r,525580,254821,270759,679002,528140,150862,474370,113296,361074,679002,118915,124506,138034,122959,282834,134147,85902,62785,-9,20,15,9,-11,12,19,-7,12,-10,35,-3,0
2020,IL,13,151648,181373,333021,1,r,541694,261880,279814,698830,565536,133294,453051,141623,311428,698830,121932,118810,130187,115755,283501,130699,84636,68166,-9,20,15,9,-11,12,19,-7,12,-10,35,-3,0
2020,IL,14,203209,197835,401044,1,d,523833,257786,266047,727525,626402,101123,489571,208675,280896,727525,104812,149245,152779,107773,256715,55184,73153,128378,-9,20,15,9,-11,12,19,-7,12,-10,35,-3,0
2020,IL,15,88559,244947,333506,0,r,529276,263497,265779,685859,633301,52558,479240,100156,379084,685859,103436,125877,140415,132523,277166,124399,87847,64920,-9,20,15,9,-11,12,19,-7,12,-10,35,-3,0
2020,IL,16,119313,218839,338152,1,r,530970,261689,269281,694262,619971,74291,480220,112698,367522,694262,109288,125961,141556,130897,278976,108372,92378,78226,-9,20,15,9,-11,12,19,-7,12,-10,35,-3,0
2020,IL,17,156011,143863,299874,1,d,503019,244766,258253,666201,541536,124665,459311,92770,366541,666201,103338,120153,132272,128276,279176,138464,87146,53566,-9,20,15,9,-11,12,19,-7,12,-10,35,-3,0
2020,IL,18,110039,261840,371879,1,r,529986,255269,274717,702289,633960,68329,483135,162226,320909,702289,110787,128665,133785,136883,280748,104102,90311,86335,-9,20,15,9,-11,12,19,-7,12,-10,35,-3,0
2020,IL,2,234896,63142,298038,1,d,504853,228980,275873,685695,259846,425849,458173,106655,351518,685695,119583,121576,137815,107948,259880,126247,75521,58112,-9,20,15,9,-11,12,19,-7,12,-10,35,-3,0
2020,IL,3,172997,133851,306848,0,d,485828,237914,247914,702503,543259,159244,484065,151081,332984,702503,113169,140275,139316,115164,245983,82186,73570,90227,-9,20,15,9,-11,12,19,-7,12,-10,35,-3,0
2020,IL,4,187219,35518,222737,1,d,396371,196757,199614,676674,392916,283758,454477,126173,328304,676674,161379,138753,112378,76187,227057,95727,69796,61534,-9,20,15,9,-11,12,19,-7,12,-10,35,-3,0
2020,IL,5,255661,96200,361269,1,d,535070,262230,272840,739401,586340,153061,534745,303569,231176,739401,185947,160569,125611,95709,303552,79304,79911,144337,-9,20,15,9,-11,12,19,-7,12,-10,35,-3,0
2020,IL,6,213777,183891,404747,1,d,517458,252364,265094,710626,583032,127594,495270,263303,231967,710626,93617,139504,158340,122161,266761,54235,70093,142433,-9,20,15,9,-11,12,19,-7,12,-10,35,-3,0
2020,IL,7,249383,41390,310128,1,d,527605,247757,279848,727761,287759,440002,515013,231145,283868,727761,182226,142792,120962,101526,306915,131464,67994,107457,-9,20,15,9,-11,12,19,-7,12,-10,35,-3,0
2020,IL,8,186251,0,254578,1,d,456651,222596,234055,717115,467007,250108,487915,170740,317175,717115,133783,142336,140279,98199,255684,75599,87708,92377,-9,20,15,9,-11,12,19,-7,12,-10,35,-3,0
2020,IL,9,262045,107125,369170,1,d,505966,245832,260134,719256,491930,227326,511423,285095,226328,719256,121300,142045,138595,130725,285485,90508,78557,116420,-9,20,15,9,-11,12,19,-7,12,-10,35,-3,0
2020,IN,1,185180,132247,326948,0,d,540076,260051,280025,719122,511065,208057,492917,114268,378649,719122,118119,137439,144276,121883,279194,115296,85783,78115,-9,20,15,9,-11,12,19,-7,12,-10,35,-3,0
2020,IN,2,114967,183601,298568,1,r,524091,253437,270654,721469,611348,110121,477492,107538,369954,721469,117481,126981,138739,121248,268256,120570,87781,59905,-9,20,15,9,-11,12,19,-7,12,-10,35,-3,0
2020,IN,3,104762,220989,325751,1,r,542756,264754,278002,753051,650682,102369,496328,121675,374653,753051,129135,135148,142252,119970,291660,125227,100051,66382,-9,20,15,9,-11,12,19,-7,12,-10,35,-3,0
2020,IN,4,112984,225531,338515,1,r,567896,280151,287745,767105,667122,99983,500236,132843,367393,767105,137190,135885,142860,120149,294928,121161,101354,72413,-9,20,15,9,-11,12,19,-7,12,-10,35,-3,0
2020,IN,5,191226,208212,416226,0,r,585141,282096,303045,791257,666915,124342,537171,257088,280083,791257,132727,159219,153117,121322,313075,101333,91409,120333,-9,20,15,9,-11,12,19,-7,12,-10,35,-3,0
2020,IN,6,91103,225318,328212,1,r,553631,268716,284915,720190,666820,53370,492910,106432,386478,720190,115649,128557,146722,129507,280444,124006,93574,62864,-9,20,15,9,-11,12,19,-7,12,-10,35,-3,0
2020,IN,7,176422,106146,282568,1,d,531047,247712,283335,777205,449793,327412,503912,125856,378056,777205,164485,146118,133129,95364,296794,157644,91358,47792,-9,20,15,9,-11,12,19,-7,12,-10,35,-3,0
2020,IN,8,95691,214643,320617,1,r,547306,269365,277941,716924,653565,63359,490069,108514,381555,716924,117069,127902,143413,129058,286330,131997,93701,60632,-9,20,15,9,-11,12,19,-7,12,-10,35,-3,0
2020,IN,9,124826,218606,359033,1,r,586412,285219,301193,765896,694589,71307,510980,138612,372368,765896,126944,142227,147236,125971,287084,117824,94200,75060,-9,20,15,9,-11,12,19,-7,12,-10,35,-3,0
2020,KS,1,84393,208229,292622,0,r,501367,253019,248348,694498,610172,84326,446568,116571,329997,694498,121069,116848,121217,121609,272404,123493,91095,57816,-9,20,15,9,-11,12,19,-7,12,-10,35,-3,0
2020,KS,2,136650,185464,336315,0,r,544073,267028,277045,715881,618520,97361,471165,138693,332472,715881,121501,122126,136496,126905,286494,126772,93914,65808,-9,20,15,9,-11,12,19,-7,12,-10,35,-3,0
2020,KS,3,220049,178773,410418,1,d,540910,260944,279966,779860,616313,163547,523115,253915,269200,779860,137578,157875,143831,112983,297879,84455,96940,116484,-9,20,15,9,-11,12,19,-7,12,-10,35,-3,0
2020,KS,4,116166,203432,319598,1,r,517398,254107,263291,723075,591897,131178,477233,143310,333923,723075,123235,129701,134617,116499,281552,119786,92773,68993,-9,20,15,9,-11,12,19,-7,12,-10,35,-3,0
2020,KY,1,82141,246329,328470,1,r,555777,272527,283250,717704,636458,81246,494156,84834,409322,717704,116632,128441,141967,136103,284068,148996,90159,44913,-9,20,15,9,-11,12,19,-7,12,-10,35,-3,0
2020,KY,2,94643,255735,360397,1,r,577344,279301,298043,774897,690264,84633,520460,114067,406393,774897,127611,145339,151427,126528,293329,135987,96249,61093,-9,20,15,9,-11,12,19,-7,12,-10,35,-3,0
2020,KY,3,230672,137425,368097,1,d,548524,259814,288710,742543,526605,215938,515876,177522,338354,742543,138940,138053,143403,123986,307525,133949,99795,73781,-9,20,15,9,-11,12,19,-7,12,-10,35,-3,0
2020,KY,4,125896,256613,382509,1,r,568729,278675,290054,761936,700198,61738,519602,150646,368956,761936,120718,148143,154435,123467,287996,108432,88230,91334,-9,20,15,9,-11,12,19,-7,12,-10,35,-3,0
2020,KY,5,47056,250914,297970,1,r,534351,262826,271525,689793,665179,24614,481489,66554,414935,689793,101488,131863,140513,125657,266136,165815,68175,32146,-9,20,15,9,-11,12,19,-7,12,-10,35,-3,0
2020,KY,6,155011,216948,378450,1,r,582777,278582,304195,780800,654987,125813,516859,172300,344559,780800,139758,146256,147349,118818,309678,138181,97460,74037,-9,20,15,9,-11,12,19,-7,12,-10,35,-3,0
2020,LA,1,94730,270330,374369,1,r,588760,276187,312573,799917,635105,164812,550828,177443,373385,799917,128567,152957,155858,139079,299885,122548,90460,86877,-9,20,15,9,-11,12,19,-7,12,-10,35,-3,0
2020,LA,2,235320,63140,316982,1,d,592763,280529,312234,788021,247449,540572,546309,139399,406910,788021,152441,148495,154390,120842,296502,160494,76221,59787,-9,20,15,9,-11,12,19,-7,12,-10,35,-3,0
2020,LA,3,100275,230480,340120,1,r,579437,277582,301855,785101,548286,236815,524549,122293,402256,785101,134515,148142,147463,118430,297618,144016,83323,70279,-9,20,15,9,-11,12,19,-7,12,-10,35,-3,0
2020,LA,4,101970,204608,306578,1,r,555133,269729,285404,737674,448340,289334,497940,95950,401990,737674,126074,135831,137329,128464,284771,155466,76604,52701,-9,20,15,9,-11,12,19,-7,12,-10,35,-3,0
2020,LA,5,99566,209990,309556,0,r,554470,270866,283604,734377,445163,289214,491876,89504,402372,734377,118806,138738,140556,119914,269916,155069,70706,44141,-9,20,15,9,-11,12,19,-7,12,-10,35,-3,0
2020,LA,6,95541,265706,373996,1,r,592809,280259,312550,803704,550441,253263,528699,159686,369013,803704,153685,154982,139840,115465,292384,114052,88279,90053,-9,20,15,9,-11,12,19,-7,12,-10,35,-3,0
2020,MA,1,0,0,0,1,d,561563,266707,294856,723831,606927,116904,505119,155651,349468,723831,118206,129965,149798,135576,287065,117654,82808,86603,-9,20,15,9,-11,12,19,-7,12,-10,35,-3,0
2020,MA,2,249854,132220,382074,1,d,573313,272718,300595,759750,631470,128280,520484,211911,308573,759750,126244,139386,158948,127028,289018,95038,80422,113558,-9,20,15,9,-11,12,19,-7,12,-10,35,-3,0
2020,MA,3,0,0,0,1,d,549542,271829,277713,771723,570854,200869,538304,206654,331650,771723,138430,151799,163442,115987,287751,90078,80234,117439,-9,20,15,9,-11,12,19,-7,12,-10,35,-3,0
2020,MA,4,251102,160474,411576,0,d,562422,266087,296335,765466,640671,124795,529675,275217,254458,765466,117838,147276,164639,127876,282691,69654,64415,148622,-9,20,15,9,-11,12,19,-7,12,-10,35,-3,0
2020,MA,5,294427,101351,395778,1,d,529999,254864,275135,768043,567113,200930,542354,326086,216268,768043,157785,150140,145113,123477,296859,69796,69463,157600,-9,20,15,9,-11,12,19,-7,12,-10,35,-3,0
2020,MA,6,286377,150695,437072,1,d,571911,268198,303713,770998,654348,116650,549559,260353,289206,770998,114039,147674,168033,147077,294824,75000,77019,142805,-9,20,15,9,-11,12,19,-7,12,-10,35,-3,0
2020,MA,7,267362,0,306037,1,d,555533,261307,294226,819035,405025,414010,555195,261737,293458,819035,236627,151690,122750,93297,302369,108985,76096,117288,-9,20,15,9,-11,12,19,-7,12,-10,35,-3,0
2020,MA,8,310940,0,383000,1,d,573152,272535,300617,765516,571726,193790,564213,277768,286445,765516,155755,147695,156808,131719,304233,78805,71708,153720,-9,20,15,9,-11,12,19,-7,12,-10,35,-3,0
2020,MA,9,260262,154261,424240,1,d,579757,273679,306078,748141,657251,90890,545673,206366,339307,748141,109285,131230,159287,170256,305870,100835,88215,116820,-9,20,15,9,-11,12,19,-7,12,-10,35,-3,0
2020,MD,1,143877,250901,394778,1,r,567020,273439,293581,737341,603276,134065,518325,171598,346727,737341,110310,130821,159297,143316,280274,87580,83909,108785,-9,20,15,9,-11,12,19,-7,12,-10,35,-3,0
2020,MD,2,224836,106355,331191,1,d,547348,259876,287472,750702,382427,368275,515050,169636,345414,750702,144431,146821,142405,110002,281891,94683,90780,96428,-9,20,15,9,-11,12,19,-7,12,-10,35,-3,0
2020,MD,3,260358,112117,372475,1,d,559105,260878,298227,779502,481237,298265,533093,278512,254581,779502,147125,153075,145357,115022,292767,72090,81687,138990,-9,20,15,9,-11,12,19,-7,12,-10,35,-3,0
2020,MD,4,282119,71671,353790,1,d,499522,232895,266627,758795,216598,542197,524525,186591,337934,758795,135659,155258,151031,107267,274009,66936,90492,116581,-9,20,15,9,-11,12,19,-7,12,-10,35,-3,0
2020,MD,5,274210,123525,397735,1,d,548323,259765,288558,756743,354165,402578,513130,176078,337052,756743,126636,147444,160287,110218,261745,56004,72244,133497,-9,20,15,9,-11,12,19,-7,12,-10,35,-3,0
2020,MD,6,215540,143599,366032,1,d,534386,260089,274297,769046,510251,258795,534906,231685,303221,769046,124222,159347,158408,117976,274499,75942,75613,122944,-9,20,15,9,-11,12,19,-7,12,-10,35,-3,0
2020,MD,7,237084,92825,329909,1,d,539189,253218,285971,717158,255721,461437,504168,202150,302018,717158,127698,136087,148325,117337,279322,115176,69625,94521,-9,20,15,9,-11,12,19,-7,12,-10,35,-3,0
2020,MD,8,274716,0,401873,1,d,522028,249861,272167,776393,493234,283159,540661,293980,246681,776393,118554,156046,153383,138749,282260,61788,67813,152659,-9,20,15,9,-11,12,19,-7,12,-10,35,-3,0
2020,ME,1,271004,165008,436012,1,d,550561,264141,286420,686731,642538,44193,509126,206434,302692,686731,111463,124934,150749,144026,293012,107200,95969,89843,-9,20,15,9,-11,12,19,-7,12,-10,35,-3,0
2020,ME,2,197835,175006,372841,1,d,528209,257903,270306,657481,620749,36732,482026,122565,359461,657481,94916,116895,148364,141952,280606,137029,88218,55359,-9,20,15,9,-11,12,19,-7,12,-10,35,-3,0
2020,MI,1,153328,256581,416219,1,r,565370,285322,280048,697102,642735,54367,512016,133978,378038,697102,98837,113786,154363,168721,298748,143182,99986,55580,-9,20,15,9,-11,12,19,-7,12,-10,35,-3,0
2020,MI,10,138179,271607,409786,0,r,554418,272654,281764,721753,663644,58109,512931,127642,385289,721753,105831,133159,160725,139079,287019,102641,94058,90320,-9,20,15,9,-11,12,19,-7,12,-10,35,-3,0
2020,MI,11,226128,215405,450469,1,d,537952,264093,273859,735677,593221,142456,525011,257804,267207,735677,113029,141866,163766,129888,292059,74435,88559,129065,-9,20,15,9,-11,12,19,-7,12,-10,35,-3,0
2020,MI,12,254957,117719,383823,1,d,525725,251851,273874,704912,547006,157906,466273,162530,303743,704912,140052,124430,130299,109153,277907,108950,90279,78678,-9,20,15,9,-11,12,19,-7,12,-10,35,-3,0
2020,MI,13,223205,53311,285879,1,d,485588,227640,257948,672291,258937,413354,441701,70598,371103,672291,130266,121753,121262,96286,264757,157742,72095,34920,-9,20,15,9,-11,12,19,-7,12,-10,35,-3,0
2020,MI,14,271370,62664,342303,1,d,496156,230572,265584,689939,234993,454946,472011,165397,306614,689939,136220,121704,130725,111115,273932,135769,74542,63621,-9,20,15,9,-11,12,19,-7,12,-10,35,-3,0
2020,MI,2,154122,238711,403247,1,r,553948,270000,283948,746998,633304,113694,493749,135723,358026,746998,128857,132864,140707,123036,280717,115055,99753,65909,-9,20,15,9,-11,12,19,-7,12,-10,35,-3,0
2020,MI,3,189769,213649,403418,0,,554738,273046,281692,752287,623004,129283,509559,163381,346178,752287,136678,141045,143557,115897,283800,111131,91735,80934,-9,20,15,9,-11,12,19,-7,12,-10,35,-3,0
2020,MI,4,120802,242621,373245,1,r,554656,276350,278306,702887,658899,43988,485349,113479,371870,702887,106897,121176,144768,138635,272535,124913,87473,60149,-9,20,15,9,-11,12,19,-7,12,-10,35,-3,0
2020,MI,5,196599,150772,361032,1,d,521742,249238,272504,672466,518850,153616,473345,95532,377813,672466,108166,118338,142897,128491,284841,149698,85184,49959,-9,20,15,9,-11,12,19,-7,12,-10,35,-3,0
2020,MI,6,152085,211496,378420,1,r,542562,264833,277729,721508,612051,109457,483048,137745,345303,721508,124041,127886,139707,128301,283902,125320,92790,65792,-9,20,15,9,-11,12,19,-7,12,-10,35,-3,0
2020,MI,7,159743,227524,387267,1,r,550964,275688,275276,710064,645163,64901,500720,133708,367012,710064,108977,130016,152749,135879,280096,111909,93905,74282,-9,20,15,9,-11,12,19,-7,12,-10,35,-3,0
2020,MI,8,217922,202525,428344,1,d,562613,270124,292489,740750,630546,110204,495623,209285,286338,740750,117671,136196,153648,117388,284819,95328,84579,104912,-9,20,15,9,-11,12,19,-7,12,-10,35,-3,0
2020,MI,9,230318,153296,399116,1,d,556032,265175,290857,718223,549812,168411,523291,163993,359298,718223,144517,136156,146646,124540,304748,120748,103328,80672,-9,20,15,9,-11,12,19,-7,12,-10,35,-3,0
2020,MN,1,167890,179234,368572,1,r,497765,244261,253504,679003,604755,74248,455430,141655,313775,679003,112344,119199,127994,121175,273667,100967,94994,77706,-9,20,15,9,-11,12,19,-7,12,-10,35,-3,0
2020,MN,2,204534,194954,424239,1,d,517880,253501,264379,717698,593539,124159,481445,195985,285460,717698,112327,146856,142323,103346,266732,68271,78405,120056,-9,20,15,9,-11,12,19,-7,12,-10,35,-3,0
2020,MN,3,246666,196625,443291,1,d,528462,252533,275929,730214,564634,165580,509293,255550,253743,730214,110271,150449,153117,116433,281550,60581,81883,139086,-9,20,15,9,-11,12,19,-7,12,-10,35,-3,0
2020,MN,4,245813,112730,388080,1,d,516588,248489,268099,719873,504711,215162,485867,217276,268591,719873,136736,135252,132369,108378,269193,88334,79836,101023,-9,20,15,9,-11,12,19,-7,12,-10,35,-3,0
2020,MN,5,255924,102878,396781,1,d,535070,265476,269594,724373,487035,237338,505040,243872,261168,724373,183463,140029,117504,98290,309153,114761,96332,98060,-9,20,15,9,-11,12,19,-7,12,-10,35,-3,0
2020,MN,6,140853,270901,411754,1,r,533104,268510,264594,729029,647996,81033,478637,155402,323235,729029,115123,144774,145677,97539,263748,67899,87353,108496,-9,20,15,9,-11,12,19,-7,12,-10,35,-3,0
2020,MN,7,144840,194066,363115,1,d,501373,248247,253126,668096,603675,64421,453032,105783,347249,668096,98395,112549,131211,134138,275213,111126,97795,66292,-9,20,15,9,-11,12,19,-7,12,-10,35,-3,0
2020,MN,8,147853,223432,393475,1,r,527314,264847,262467,671346,621243,50103,478468,117703,360765,671346,99437,117695,143143,142192,283312,112271,97346,73695,-9,20,15,9,-11,12,19,-7,12,-10,35,-3,0
2020,MO,1,249087,59940,315793,0,d,547921,252790,295131,727772,308948,418824,499521,167555,331966,727772,158924,133793,133815,106360,320959,159700,98367,62892,-9,20,15,9,-11,12,19,-7,12,-10,35,-3,0
2020,MO,2,204540,233157,449344,1,r,576008,272062,303946,751926,666694,85232,541357,280598,260759,751926,113594,138555,163635,151619,307657,80609,91969,135079,-9,20,15,9,-11,12,19,-7,12,-10,35,-3,0
2020,MO,3,116095,282866,407305,1,r,608065,302593,305472,802919,736085,66834,554777,157257,397520,802919,129175,156185,163220,133934,307761,106430,107704,93627,-9,20,15,9,-11,12,19,-7,12,-10,35,-3,0
2020,MO,4,107635,245247,362836,1,r,590595,290543,300052,775664,688277,87387,510236,132419,377817,775664,132022,135202,143474,131541,293159,136156,94055,62948,-9,20,15,9,-11,12,19,-7,12,-10,35,-3,0
2020,MO,5,207180,135934,352386,1,d,579431,277850,301581,777659,534414,243245,535994,159462,376532,777659,152936,142617,148050,122528,324295,147635,102887,73773,-9,20,15,9,-11,12,19,-7,12,-10,35,-3,0
2020,MO,6,118926,258709,385779,1,r,586958,285831,301127,777104,693307,83797,525235,151425,373810,777104,118947,145341,153159,131707,290828,116452,94159,80217,-9,20,15,9,-11,12,19,-7,12,-10,35,-3,0
2020,MO,7,98111,254318,368002,1,r,594430,287120,307310,787917,717901,70016,529184,131649,397535,787917,139235,138192,146736,140534,322806,166588,100459,55759,-9,20,15,9,-11,12,19,-7,12,-10,35,-3,0
2020,MO,8,70561,253811,330226,1,r,566910,280110,286800,736467,677313,59154,509858,90916,418942,736467,112572,132143,150373,139720,290872,159235,87848,43789,-9,20,15,9,-11,12,19,-7,12,-10,35,-3,0
2020,MS,1,104008,228787,332795,1,r,579478,276930,302548,769026,513762,255264,510727,109623,401104,769026,120355,147978,146997,123593,278795,138697,86653,53445,-9,20,15,9,-11,12,19,-7,12,-10,35,-3,0
2020,MS,2,196224,101010,297234,1,d,519040,245667,273373,692452,211581,480871,453070,86114,366956,692452,111720,126948,126637,111572,251496,155957,63247,32292,-9,20,15,9,-11,12,19,-7,12,-10,35,-3,0
2020,MS,3,120782,221064,341846,1,r,560442,264922,295520,738992,447016,291976,493902,131013,362889,738992,122115,137876,140455,124053,280709,140624,82173,57912,-9,20,15,9,-11,12,19,-7,12,-10,35,-3,0
2020,MS,4,0,0,0,1,r,587363,279686,307677,775679,554611,221068,521965,115001,406964,775679,117289,147585,150154,127586,289229,150979,82270,55980,-9,20,15,9,-11,12,19,-7,12,-10,35,-3,0
2020,MT,1,262340,339169,601509,0,r,831760,415318,416442,1068778,940423,128355,741950,249148,492802,1068778,172108,191061,209861,207909,437651,192020,140621,105010,-9,20,15,9,-11,12,19,-7,12,-10,35,-3,0
2020,NC,1,188870,159748,348618,1,d,570191,261649,308542,763500,359842,403658,519898,150115,369783,763500,137454,137484,146701,130551,305873,158102,88442,59329,-9,20,15,9,-11,12,19,-7,12,-10,35,-3,0
2020,NC,10,128189,284095,412284,1,r,591040,279075,311965,771791,626605,145186,549139,143803,405336,771791,119094,144950,159111,150398,298394,139314,93815,65265,-9,20,15,9,-11,12,19,-7,12,-10,35,-3,0
2020,NC,11,190609,245351,450145,0,r,607938,291752,316186,772612,691103,81509,570240,149994,420246,772612,113307,137015,163378,180333,323519,155411,104975,63133,-9,20,15,9,-11,12,19,-7,12,-10,35,-3,0
2020,NC,12,0,0,0,1,d,599115,277033,322082,891792,400802,490990,598431,248108,350323,891792,204813,190536,148954,93280,341716,132729,113068,95919,-9,20,15,9,-11,12,19,-7,12,-10,35,-3,0
2020,NC,13,124684,267181,391865,1,r,581381,275374,306007,780466,530622,249844,536460,163828,372632,780466,132998,140970,154339,133243,306521,139517,95500,71504,-9,20,15,9,-11,12,19,-7,12,-10,35,-3,0
2020,NC,2,311887,172544,495345,0,r,636164,306035,330129,888547,638363,250184,598266,229271,368995,888547,126490,189017,178993,125454,321361,109439,92764,119158,-9,20,15,9,-11,12,19,-7,12,-10,35,-3,0
2020,NC,3,132752,229800,362552,1,r,581048,294341,286707,761753,557793,203960,508338,128427,379911,761753,142381,129524,142614,135639,296678,138271,93382,65025,-9,20,15,9,-11,12,19,-7,12,-10,35,-3,0
2020,NC,4,332421,161298,493719,1,d,610536,289710,320826,873270,523931,349339,581808,325067,256741,873270,181510,184577,151325,103735,337926,110565,100584,126777,-9,20,15,9,-11,12,19,-7,12,-10,35,-3,0
2020,NC,5,119846,257843,385244,1,r,583346,277509,305837,765013,606473,158540,529567,141692,387875,765013,122037,137328,156202,141690,305576,154100,90331,61145,-9,20,15,9,-11,12,19,-7,12,-10,35,-3,0
2020,NC,6,253531,153598,407129,0,r,581560,273672,307888,791470,561103,230367,548564,138615,409949,791470,114423,149388,165809,142789,305260,140229,97123,67908,-9,20,15,9,-11,12,19,-7,12,-10,35,-3,0
2020,NC,7,179045,272443,451488,1,r,621515,292988,328527,816402,608631,207771,574460,161845,412615,816402,123443,143321,164156,168951,319329,150826,98144,70359,-9,20,15,9,-11,12,19,-7,12,-10,35,-3,0
2020,NC,8,177781,202774,380555,1,r,591696,288910,302786,815055,526577,288478,538634,148782,389852,815055,157766,147466,146419,123387,298572,136002,97523,65047,-9,20,15,9,-11,12,19,-7,12,-10,35,-3,0
2020,NC,9,179463,224661,404124,1,r,574114,273224,300890,796413,512665,283748,533272,191638,341634,796413,106205,162683,162215,121485,285623,112451,78166,95006,-9,20,15,9,-11,12,19,-7,12,-10,35,-3,0
2020,ND,1,97970,245229,355223,1,r,567545,289374,278171,762062,653910,108152,504375,153397,350978,762062,156974,134301,132323,120177,323519,124455,102645,96419,-9,20,15,9,-11,12,19,-7,12,-10,35,-3,0
2020,NE,1,119622,189006,317566,1,r,475365,235513,239852,651958,574306,77652,419704,138452,281252,651958,120321,116686,116488,101033,259127,97577,89391,72159,-9,20,15,9,-11,12,19,-7,12,-10,35,-3,0
2020,NE,2,155706,171071,336962,1,r,472694,229615,243079,684882,553442,131440,445090,187750,257340,684882,127633,134300,118514,90068,262877,90090,86106,86681,-9,20,15,9,-11,12,19,-7,12,-10,35,-3,0
2020,NE,3,50690,225157,286770,1,r,440891,218411,222480,597568,539015,58553,406976,96385,310591,597568,87883,100115,115440,121194,249440,110965,86298,52177,-9,20,15,9,-11,12,19,-7,12,-10,35,-3,0
2020,NH,1,205606,185159,400512,1,d,540722,262255,278467,686735,637422,49313,493842,188733,305109,686735,109388,129063,154204,125064,274786,82527,85620,106639,-9,20,15,9,-11,12,19,-7,12,-10,35,-3,0
2020,NH,2,208289,168886,386294,1,d,529493,263028,266465,672976,621154,51822,485908,179504,306404,672976,107132,120986,151619,128083,266610,86699,82295,97616,-9,20,15,9,-11,12,19,-7,12,-10,35,-3,0
2020,NJ,1,240567,144463,385030,1,d,539844,255478,284366,726825,494276,232549,503379,167899,335480,726825,123160,140315,147317,118007,270997,91790,76400,102807,-9,20,15,9,-11,12,19,-7,12,-10,35,-3,0
2020,NJ,10,241522,40298,290009,1,d,506649,235246,271403,761783,236569,525214,519452,168007,351445,761783,150467,153127,143331,101811,285444,117584,83555,84305,-9,20,15,9,-11,12,19,-7,12,-10,35,-3,0
2020,NJ,11,235163,206013,441176,1,d,527170,252272,274898,717657,586527,131130,509884,291196,218688,717657,100648,144044,158322,131419,270984,47477,62286,161221,-9,20,15,9,-11,12,19,-7,12,-10,35,-3,0
2020,NJ,12,230883,114591,351725,1,d,505109,243782,261327,747082,395203,351879,520687,245296,275391,747082,118287,148191,154342,124726,273400,79973,72106,121321,-9,20,15,9,-11,12,19,-7,12,-10,35,-3,0
2020,NJ,2,173849,195526,376547,1,r,528293,255315,272978,707255,523412,183843,503363,136810,366553,707255,110248,127353,151808,139974,271508,99031,82658,89819,-9,20,15,9,-11,12,19,-7,12,-10,35,-3,0
2020,NJ,3,229840,196327,431762,1,d,568535,271939,296596,735981,581851,154130,531315,191121,340194,735981,113591,135861,158356,149443,284794,73552,92055,119187,-9,20,15,9,-11,12,19,-7,12,-10,35,-3,0
2020,NJ,4,162420,254103,424368,1,r,536357,260121,276236,748199,643157,105042,508098,225033,283065,748199,106557,131318,153966,143930,275617,76928,70128,128561,-9,20,15,9,-11,12,19,-7,12,-10,35,-3,0
2020,NJ,5,225175,193333,423636,1,d,538231,260148,278083,734764,581149,153615,516379,261397,254982,734764,98921,140623,164272,138722,267665,56000,65376,146289,-9,20,15,9,-11,12,19,-7,12,-10,35,-3,0
2020,NJ,6,199648,126760,326408,1,d,502050,242878,259172,739726,451276,288450,500231,205533,294698,739726,130696,148742,145594,102850,256290,69562,67370,119358,-9,20,15,9,-11,12,19,-7,12,-10,35,-3,0
2020,NJ,7,219629,214318,433947,1,d,520886,251165,269721,734239,549923,184316,516062,282978,233084,734239,100571,149314,168519,123926,271992,52055,67204,152733,-9,20,15,9,-11,12,19,-7,12,-10,35,-3,0
2020,NJ,8,176758,58686,238773,1,d,420965,204109,216856,766357,442827,323530,531562,187751,343811,766357,178011,171992,127682,84385,287329,110522,81031,95776,-9,20,15,9,-11,12,19,-7,12,-10,35,-3,0
2020,NJ,9,203674,98629,309542,1,d,476041,227596,248445,762322,478125,284197,530817,188744,342073,762322,137475,153209,150092,115882,270244,85165,73909,111170,-9,20,15,9,-11,12,19,-7,12,-10,35,-3,0
2020,NM,1,186953,134337,321290,1,d,510328,245162,265166,691229,514572,176657,485656,167382,318274,691229,127144,130749,132456,122284,276649,125310,83370,67969,-9,20,15,9,-11,12,19,-7,12,-10,35,-3,0
2020,NM,2,122546,142283,264829,1,d,492566,246557,246009,705615,578192,127423,459519,94247,365272,705615,115084,124199,124647,124971,254925,132834,76191,45900,-9,20,15,9,-11,12,19,-7,12,-10,35,-3,0
2020,NM,3,186282,131166,317448,0,d,519277,252164,267113,699985,457189,242796,480813,132969,347844,699985,116378,124436,133143,130475,261846,121507,80373,59966,-9,20,15,9,-11,12,19,-7,12,-10,35,-3,0
2020,NV,1,137868,74490,223213,1,d,423658,214462,209196,712411,365927,346484,486893,85642,401251,712411,142190,141128,130628,100897,257962,144441,76329,37192,-9,20,15,9,-11,12,19,-7,12,-10,35,-3,0
2020,NV,2,155780,216078,382673,1,r,536143,270771,265372,736907,578127,158780,517182,141235,375947,736907,132826,133914,146291,131833,298135,105669,97927,94539,-9,20,15,9,-11,12,19,-7,12,-10,35,-3,0
2020,NV,3,203421,190975,417252,1,d,630813,309739,321074,857197,552971,304226,614749,212887,401862,857197,152633,187095,162633,141690,321058,92169,105660,123229,-9,20,15,9,-11,12,19,-7,12,-10,35,-3,0
2020,NV,4,168457,152284,332469,1,d,521318,260551,260767,773641,492091,281550,517642,109155,408487,773641,132137,146234,141265,123799,266402,104162,92964,69276,-9,20,15,9,-11,12,19,-7,12,-10,35,-3,0
2020,NY,1,169294,205715,375009,1,r,526240,253195,273045,713168,609438,103730,500228,191345,308883,713168,112129,133459,154020,128258,252630,59049,64472,129109,-9,20,15,9,-11,12,19,-7,12,-10,35,-3,0
2020,NY,10,206310,66889,276569,1,d,498723,234930,263793,732732,503607,229125,526935,333689,193246,732732,161622,146263,127330,118460,317659,86151,66160,165348,-9,20,15,9,-11,12,19,-7,12,-10,35,-3,0
2020,NY,11,137198,155608,292806,1,d,498830,233885,264945,737390,511527,225863,516311,196594,319717,737390,128047,143877,145670,125902,265022,85964,69437,109621,-9,20,15,9,-11,12,19,-7,12,-10,35,-3,0
2020,NY,12,265172,53061,322248,1,d,552090,261980,290110,725760,515038,210722,575696,417662,158034,725760,224093,152292,112453,119460,366996,79328,72143,215525,-9,20,15,9,-11,12,19,-7,12,-10,35,-3,0
2020,NY,13,231841,19829,254965,1,d,485528,219890,265638,751661,225691,525970,535132,175852,359280,751661,194064,147024,131728,100296,295057,155088,77096,62873,-9,20,15,9,-11,12,19,-7,12,-10,35,-3,0
2020,NY,14,152661,58440,213101,1,d,401473,198917,202556,696664,288342,408322,503790,141886,361904,696664,149910,147822,123959,106108,242702,90988,79060,72654,-9,20,15,9,-11,12,19,-7,12,-10,35,-3,0
2020,NY,15,169533,21221,190754,0,d,421642,186672,234970,739390,120577,618813,458160,66759,391401,739390,152555,137232,126878,75652,262833,172133,62031,28669,-9,20,15,9,-11,12,19,-7,12,-10,35,-3,0
2020,NY,16,218471,0,259556,0,d,506330,233907,272423,739893,328712,411181,514624,208975,305649,739893,119713,139334,144095,137252,277231,99333,72073,105825,-9,20,15,9,-11,12,19,-7,12,-10,35,-3,0
2020,NY,17,197353,117307,332655,0,d,495562,237981,257581,737355,509344,228011,494752,245482,249270,737355,115245,139804,146118,120851,249845,56147,55340,138358,-9,20,15,9,-11,12,19,-7,12,-10,35,-3,0
2020,NY,18,187169,145098,335429,1,d,530428,259839,270589,718624,554583,164041,484103,175023,309080,718624,112919,136619,151189,114260,253104,70811,65763,116530,-9,20,15,9,-11,12,19,-7,12,-10,35,-3,0
2020,NY,19,192100,151475,350598,1,d,555732,273985,281747,701011,610864,90147,508208,158584,349624,701011,102877,124240,159204,148092,272241,102996,82014,87231,-9,20,15,9,-11,12,19,-7,12,-10,35,-3,0
2020,NY,2,154246,177379,335073,0,r,512037,250247,261790,698974,516218,182756,485988,158638,327350,698974,116384,131293,153077,113225,223418,44044,57627,121747,-9,20,15,9,-11,12,19,-7,12,-10,35,-3,0
2020,NY,20,219705,139446,359151,1,d,560724,269068,291656,725669,568073,157596,503201,203139,300062,725669,131937,130841,141469,129486,302852,107366,88209,107277,-9,20,15,9,-11,12,19,-7,12,-10,35,-3,0
2020,NY,21,131992,188649,320641,1,r,546491,280171,266320,694835,642777,52058,487798,120669,367129,694835,114418,123742,146438,129677,280765,121654,91087,68024,-9,20,15,9,-11,12,19,-7,12,-10,35,-3,0
2020,NY,22,154997,155348,317094,1,d,533819,262176,271643,688391,610787,77604,470922,122713,348209,688391,111867,115078,142161,131296,277265,123295,87659,66311,-9,20,15,9,-11,12,19,-7,12,-10,35,-3,0
2020,NY,23,129014,181169,313724,1,r,540476,265036,275440,687583,621613,65970,471015,131930,339085,687583,106939,113480,141179,134467,282880,130874,89585,62421,-9,20,15,9,-11,12,19,-7,12,-10,35,-3,0
2020,NY,24,147638,182567,343437,1,r,539232,259517,279715,701841,584533,117308,486072,155415,330657,701841,110247,125528,147145,124519,280843,116245,89024,75574,-9,20,15,9,-11,12,19,-7,12,-10,35,-3,0
2020,NY,25,206396,136198,347919,1,d,547133,259388,287745,714657,535686,178971,497620,200907,296713,714657,131948,125200,141181,127736,294719,121589,89005,84125,-9,20,15,9,-11,12,19,-7,12,-10,35,-3,0
2020,NY,26,223276,91687,319591,1,d,540265,255400,284865,703114,494724,208390,490956,154855,336101,703114,140903,119813,137982,122413,311623,148735,93360,69528,-9,20,15,9,-11,12,19,-7,12,-10,35,-3,0
2020,NY,27,149559,229044,383487,1,r,568055,280695,287360,719554,666977,52577,519888,172250,347638,719554,106541,131526,162084,143408,296942,103234,98367,95341,-9,20,15,9,-11,12,19,-7,12,-10,35,-3,0
2020,NY,3,208555,161931,372642,1,d,536640,258653,277987,725746,532099,193647,522984,293960,229024,725746,100980,130192,164042,155814,257333,50300,52231,154802,-9,20,15,9,-11,12,19,-7,12,-10,35,-3,0
2020,NY,4,199762,153007,355793,1,d,512546,247035,265511,730314,470752,259562,509901,222249,287652,730314,120366,143971,148323,122940,238571,52138,56366,130067,-9,20,15,9,-11,12,19,-7,12,-10,35,-3,0
2020,NY,5,0,0,0,1,d,495842,228514,267328,759001,131438,627563,525292,135812,389480,759001,134649,142787,156053,121331,230322,76043,66998,87281,-9,20,15,9,-11,12,19,-7,12,-10,35,-3,0
2020,NY,6,158862,74829,233691,1,d,434571,207640,226931,714299,295148,419151,527007,201178,325829,714299,121980,147013,154372,124241,266127,98366,71414,96347,-9,20,15,9,-11,12,19,-7,12,-10,35,-3,0
2020,NY,7,191073,32520,225115,1,d,443176,216649,226527,698794,338843,359951,488355,179887,308468,698794,172751,144999,115344,87384,253213,103353,61576,88284,-9,20,15,9,-11,12,19,-7,12,-10,35,-3,0
2020,NY,8,234933,42007,276940,1,d,545882,237340,308542,776825,245758,531067,549655,193648,356007,776825,179603,150225,134758,120604,308982,135498,80292,93192,-9,20,15,9,-11,12,19,-7,12,-10,35,-3,0
2020,NY,9,230221,43950,276867,1,d,481363,218139,263224,720316,260531,459785,510141,207117,303024,720316,151377,142279,129167,112836,285637,108684,75089,101864,-9,20,15,9,-11,12,19,-7,12,-10,35,-3,0
2020,OH,1,172022,199560,385274,1,r,550781,266070,284711,749773,530281,219492,498444,188679,309765,749773,130363,137751,147167,109166,300336,115811,88131,96394,-9,20,15,9,-11,12,19,-7,12,-10,35,-3,0
2020,OH,10,151976,212972,364948,1,r,552940,262794,290146,723716,546380,177336,495847,153877,341970,723716,126952,125443,139100,131987,300821,134062,94984,71775,-9,20,15,9,-11,12,19,-7,12,-10,35,-3,0
2020,OH,11,242098,60323,302421,1,d,525057,245327,279730,684617,272681,411936,475195,133131,342064,684617,131887,115746,137341,120193,307046,172133,81541,53372,-9,20,15,9,-11,12,19,-7,12,-10,35,-3,0
2020,OH,12,182847,241790,437672,1,r,588304,284671,303633,788335,681978,106357,540443,228210,312233,788335,124943,163342,153587,125940,301083,94401,94001,112681,-9,20,15,9,-11,12,19,-7,12,-10,35,-3,0
2020,OH,13,173631,148648,330801,1,d,560255,266690,293565,704191,571945,132246,495839,117353,378486,704191,126496,121156,144596,137519,301973,161314,91804,48855,-9,20,15,9,-11,12,19,-7,12,-10,35,-3,0
2020,OH,14,158586,238864,397450,1,r,553234,265802,287432,714870,644694,70176,510188,172727,337461,714870,98837,130234,154395,148210,289183,103355,93880,91948,-9,20,15,9,-11,12,19,-7,12,-10,35,-3,0
2020,OH,15,140183,243103,383286,1,r,594787,299132,295655,769664,687485,82179,538878,187110,351768,769664,141884,153226,152163,118540,293600,101098,94788,97714,-9,20,15,9,-11,12,19,-7,12,-10,35,-3,0
2020,OH,16,144071,247335,391406,1,r,556708,268467,288241,719744,667377,52367,514273,182664,331609,719744,107280,129659,151621,149127,298797,103648,101742,93407,-9,20,15,9,-11,12,19,-7,12,-10,35,-3,0
2020,OH,2,146781,230430,377211,1,r,555323,265446,289877,730151,629338,100813,511599,169303,342296,730151,125967,136181,145304,130770,301403,123967,86966,90470,-9,20,15,9,-11,12,19,-7,12,-10,35,-3,0
2020,OH,3,227420,93569,320989,1,d,565727,272441,293286,813890,430038,383852,524905,156735,368170,813890,179709,149682,136048,89219,318400,152533,102806,63061,-9,20,15,9,-11,12,19,-7,12,-10,35,-3,0
2020,OH,4,101897,235875,347626,1,r,550776,272622,278154,712261,635946,76315,495000,99045,395955,712261,110231,132708,147093,130897,286055,117506,104284,64265,-9,20,15,9,-11,12,19,-7,12,-10,35,-3,0
2020,OH,5,120962,257019,377981,1,r,553726,267647,286079,721212,657924,63288,491700,137702,353998,721212,118887,125021,145375,129747,293869,114064,99880,79925,-9,20,15,9,-11,12,19,-7,12,-10,35,-3,0
2020,OH,6,85661,249130,334791,1,r,549999,271981,278018,698284,664685,33599,496262,88562,407700,698284,100022,124590,150579,142323,275138,130756,89349,55033,-9,20,15,9,-11,12,19,-7,12,-10,35,-3,0
2020,OH,7,102271,236607,350549,1,r,553091,269427,283664,727011,669556,57455,499046,105188,393858,727011,101344,130751,147858,137858,284461,122779,98495,63187,-9,20,15,9,-11,12,19,-7,12,-10,35,-3,0
2020,OH,8,110766,246277,357043,1,r,547822,265094,282728,733811,642366,91445,487504,123116,364388,733811,111484,133226,145155,125298,280620,111042,93904,75674,-9,20,15,9,-11,12,19,-7,12,-10,35,-3,0
2020,OH,9,190328,111385,301713,1,d,520939,244657,276282,697570,519976,177594,474682,113183,361499,697570,127902,121099,134338,116754,297555,161769,86475,49311,-9,20,15,9,-11,12,19,-7,12,-10,35,-3,0
2020,OK,1,109641,213700,335471,1,r,574642,275491,299151,809500,575809,233691,538008,172307,365701,809500,143936,152239,146873,123332,314493,132936,97978,83579,-9,20,15,9,-11,12,19,-7,12,-10,35,-3,0
2020,OK,2,63472,216511,288527,1,r,565049,276822,288227,747337,492262,255075,507310,88341,418969,747337,114509,131319,143870,143960,285136,155377,84352,45407,-9,20,15,9,-11,12,19,-7,12,-10,35,-3,0
2020,OK,3,66501,242677,309178,1,r,568862,283185,285677,782091,623806,158285,512294,121357,390937,782091,129162,144732,140192,128220,286280,131775,93863,60642,-9,20,15,9,-11,12,19,-7,12,-10,35,-3,0
2020,OK,4,90459,213096,314358,1,r,594411,295648,298763,792928,595524,197404,518821,133184,385637,792928,143595,146329,142882,121724,293347,122912,93822,76613,-9,20,15,9,-11,12,19,-7,12,-10,35,-3,0
2020,OK,5,145658,158191,303849,1,d,572095,272906,299189,825115,578384,246731,542811,171320,371491,825115,160173,153255,145328,117986,315895,142333,96899,76663,-9,20,15,9,-11,12,19,-7,12,-10,35,-3,0
2020,OR,1,297071,161928,458999,1,d,617472,302266,315206,858875,673842,185033,603297,245802,357495,858875,162431,179180,160230,132328,325950,92509,104170,129271,-9,20,15,9,-11,12,19,-7,12,-10,35,-3,0
2020,OR,2,168881,273835,456810,0,r,638108,313988,324120,841022,754274,86748,600342,161824,438518,841022,129302,155683,161319,181462,330768,143684,105184,81900,-9,20,15,9,-11,12,19,-7,12,-10,35,-3,0
2020,OR,3,343574,110570,469885,1,d,641510,316334,325176,853116,666779,186337,621311,275258,346053,853116,185152,196575,150729,121598,341703,113790,104533,123380,-9,20,15,9,-11,12,19,-7,12,-10,35,-3,0
2020,OR,4,240950,216081,467149,1,d,650640,315657,334983,820504,721421,99083,579277,162798,416479,820504,144033,140686,157896,178390,335886,151837,105613,78436,-9,20,15,9,-11,12,19,-7,12,-10,35,-3,0
2020,OR,5,234863,204372,451875,1,d,614474,297176,317298,844220,707537,136683,583891,186634,397257,844220,136947,162231,161505,153718,315045,111236,103087,100722,-9,20,15,9,-11,12,19,-7,12,-10,35,-3,0
2020,PA,1,191875,249804,441679,1,r,542506,262756,279750,713411,609026,104385,513375,218597,294778,713411,105453,136900,161282,134506,272563,69918,75287,127358,-9,20,15,9,-11,12,19,-7,12,-10,35,-3,0
2020,PA,10,182938,208896,391834,1,r,558693,268526,290167,744681,581914,162767,520990,167880,353110,744681,122867,138740,150707,132060,299825,110714,98497,90614,-9,20,15,9,-11,12,19,-7,12,-10,35,-3,0
2020,PA,11,141325,241915,383240,1,r,555086,269815,285271,734038,653693,80345,504501,141625,362876,734038,120248,130252,142144,136974,278868,95865,100852,82151,-9,20,15,9,-11,12,19,-7,12,-10,35,-3,0
2020,PA,12,99052,240717,339769,1,r,552013,274549,277464,701387,658067,43320,479498,113997,365501,701387,111249,116622,140753,139355,276084,123911,91493,60680,-9,20,15,9,-11,12,19,-7,12,-10,35,-3,0
2020,PA,13,96612,267789,364401,1,r,548308,270916,277392,697051,650844,46207,498802,102769,396033,697051,99251,124290,148675,148712,281524,126025,95718,59781,-9,20,15,9,-11,12,19,-7,12,-10,35,-3,0
2020,PA,14,131862,241668,373530,1,r,545910,265528,280382,678915,633984,44931,497954,136992,360962,678915,98206,120896,150812,149524,292836,126974,89018,76844,-9,20,15,9,-11,12,19,-7,12,-10,35,-3,0
2020,PA,15,92143,255051,347194,1,r,543052,276035,267017,672749,640736,32013,489551,101056,388495,672749,105600,118379,147126,143105,280673,131203,92840,56630,-9,20,15,9,-11,12,19,-7,12,-10,35,-3,0
2020,PA,16,143865,210008,353873,1,r,537685,260600,277085,678333,614553,63780,478760,135306,343454,678333,103287,118363,143807,136620,283627,129898,89200,64529,-9,20,15,9,-11,12,19,-7,12,-10,35,-3,0
2020,PA,17,222242,212279,434521,1,d,551560,267975,283585,706961,622904,84057,524090,222844,301246,706961,112639,134847,151612,144802,313101,108686,96187,108228,-9,20,15,9,-11,12,19,-7,12,-10,35,-3,0
2020,PA,18,266084,118163,384247,1,d,548814,255698,293116,693858,510053,183805,497256,198739,298517,693858,148872,116338,131627,130772,320533,139008,95998,85527,-9,20,15,9,-11,12,19,-7,12,-10,35,-3,0
2020,PA,2,198140,75022,273162,1,d,491451,230925,260526,722722,325152,397570,489578,110669,378909,722722,140566,138215,133236,97779,259215,136550,69947,52718,-9,20,15,9,-11,12,19,-7,12,-10,35,-3,0
2020,PA,3,341708,33671,375379,1,d,573719,260749,312970,741654,246857,494797,517347,210046,307301,741654,207208,126792,117963,107829,315700,158058,85833,71809,-9,20,15,9,-11,12,19,-7,12,-10,35,-3,0
2020,PA,4,264637,179926,444563,1,d,552061,264975,287086,730701,581586,149115,518644,251675,266969,730701,117524,139408,151930,134669,283530,72449,80914,130167,-9,20,15,9,-11,12,19,-7,12,-10,35,-3,0
2020,PA,5,255743,139552,395295,1,d,525272,244308,280964,719973,456095,263878,490625,192282,298343,719973,121181,136126,141222,117700,267150,99220,71441,96489,-9,20,15,9,-11,12,19,-7,12,-10,35,-3,0
2020,PA,6,226440,177526,403966,1,d,533141,260414,272727,735283,573777,161506,495820,231326,264494,735283,116477,139256,147432,120542,270267,77938,74175,118154,-9,20,15,9,-11,12,19,-7,12,-10,35,-3,0
2020,PA,7,195713,181569,377282,1,d,550950,265506,285444,731467,600026,131441,507566,152682,354884,731467,117158,133980,149095,132534,272657,98776,85315,88566,-9,20,15,9,-11,12,19,-7,12,-10,35,-3,0
2020,PA,8,178407,166201,344608,1,d,543310,267504,275806,698973,589106,109867,500010,121603,378407,698973,109410,127548,148630,139436,275550,122376,91855,61319,-9,20,15,9,-11,12,19,-7,12,-10,35,-3,0
2020,PA,9,118266,232988,351254,1,r,556670,276821,279849,699832,645419,54413,503669,107314,396355,699832,104687,126042,153914,141299,275546,107788,94524,73234,-9,20,15,9,-11,12,19,-7,12,-10,35,-3,0
2020,RI,1,158550,0,222307,1,d,391053,188707,202346,530066,402110,127956,366838,125528,241310,530066,91616,93435,109467,90765,201963,79202,60944,61817,-9,20,15,9,-11,12,19,-7,12,-10,35,-3,0
2020,RI,2,154086,109894,263980,1,d,409745,193531,216214,529295,431580,97715,380114,134747,245367,529295,94077,98912,109803,96390,205211,67747,64387,73077,-9,20,15,9,-11,12,19,-7,12,-10,35,-3,0
2020,SC,1,210627,216042,426669,1,d,615755,291781,323974,821107,591572,229535,579978,237117,342861,821107,140632,154619,155210,154690,311963,98275,97500,116188,-9,20,15,9,-11,12,19,-7,12,-10,35,-3,0
2020,SC,2,155118,202715,363996,1,r,541862,257460,284402,722542,501142,221400,493815,173419,320396,722542,117582,134923,141824,121670,280589,116759,86689,77141,-9,20,15,9,-11,12,19,-7,12,-10,35,-3,0
2020,SC,3,95712,237544,333256,1,r,540303,259782,280521,706961,531157,175804,483422,115315,368107,706961,110678,124482,141015,133520,266671,130860,83461,52350,-9,20,15,9,-11,12,19,-7,12,-10,35,-3,0
2020,SC,4,133023,222126,360239,1,r,555462,262763,292699,754148,553998,200150,517193,172981,344212,754148,133574,142928,143927,124355,289536,118363,93708,77465,-9,20,15,9,-11,12,19,-7,12,-10,35,-3,0
2020,SC,5,145979,220006,365985,1,r,553076,261061,292015,738205,502928,235277,511308,134617,376691,738205,110456,145300,147712,128587,286307,125325,87550,73432,-9,20,15,9,-11,12,19,-7,12,-10,35,-3,0
2020,SC,6,197477,89258,289381,1,d,510628,246100,264528,665215,253612,411603,444138,101612,342526,665215,122177,117183,124910,107783,251006,145562,69918,35526,-9,20,15,9,-11,12,19,-7,12,-10,35,-3,0
2020,SC,7,138863,224993,363856,1,r,575255,268150,307105,740536,500058,240478,533350,119498,413852,740536,108573,126689,156185,164933,289843,146454,88209,55180,-9,20,15,9,-11,12,19,-7,12,-10,35,-3,0
2020,SD,1,0,321984,397732,1,r,653394,327804,325590,884659,743764,140895,588029,174784,413245,884659,149674,154415,165394,153799,353799,144784,120228,88787,-9,20,15,9,-11,12,19,-7,12,-10,35,-3,0
2020,TN,1,68617,228181,305419,0,r,570495,275224,295271,725173,682102,43071,521341,114150,407191,725173,113556,129763,154193,150751,301451,156078,92129,53244,-9,20,15,9,-11,12,19,-7,12,-10,35,-3,0
2020,TN,2,109684,238907,353183,1,r,587665,281680,305985,758519,675194,83325,525640,163949,361691,758519,133596,138450,150304,138900,304715,134070,94272,76373,-9,20,15,9,-11,12,19,-7,12,-10,35,-3,0
2020,TN,3,97687,215571,320291,1,r,573580,278503,295077,743225,627339,115886,525977,137475,388502,743225,120792,138311,151986,141531,294614,138844,91314,64456,-9,20,15,9,-11,12,19,-7,12,-10,35,-3,0
2020,TN,4,111908,223802,335710,1,r,596604,286724,309880,812697,677310,135387,539909,128318,411591,812697,139460,154081,155940,121936,296321,125862,100417,70042,-9,20,15,9,-11,12,19,-7,12,-10,35,-3,0
2020,TN,5,0,0,0,1,d,564374,267188,297186,778094,517223,260871,543345,233370,309975,778094,187810,151279,136726,100773,320384,122644,106445,91295,-9,20,15,9,-11,12,19,-7,12,-10,35,-3,0
2020,TN,6,83852,257572,349578,1,r,608091,295461,312630,799365,714233,85132,558346,139626,418720,799365,121633,153670,161950,143851,303648,129766,98885,74997,-9,20,15,9,-11,12,19,-7,12,-10,35,-3,0
2020,TN,7,95839,245188,350635,1,r,590210,287264,302946,800536,667562,132974,532755,171071,361684,800536,124698,160713,152251,122091,292062,119931,85118,87013,-9,20,15,9,-11,12,19,-7,12,-10,35,-3,0
2020,TN,8,97890,227216,331853,1,r,536275,255333,280942,711068,518912,192156,487919,149387,338532,711068,101183,136031,146528,126839,271504,114694,79378,77432,-9,20,15,9,-11,12,19,-7,12,-10,35,-3,0
2020,TN,9,187905,48818,242877,1,d,502286,228925,273361,700497,193035,507462,458730,110878,347852,700497,152416,122958,124984,92293,270038,150785,77298,41955,-9,20,15,9,-11,12,19,-7,12,-10,35,-3,0
2020,TX,1,83016,219726,302742,1,r,518180,248307,269873,726094,562797,163297,478757,105701,373056,726094,120705,127235,128418,128891,259325,118999,83273,57053,-9,20,15,9,-11,12,19,-7,12,-10,35,-3,0
2020,TX,10,187686,217216,413894,1,r,604700,290071,314629,925348,648467,276881,610749,252627,358122,925348,162731,198275,161324,113783,321723,97806,96869,127048,-9,20,15,9,-11,12,19,-7,12,-10,35,-3,0
2020,TX,11,53394,232568,291773,0,r,543743,265375,278368,790264,656552,133712,517878,119506,398372,790264,141938,143077,137195,123131,280662,110383,85332,84947,-9,20,15,9,-11,12,19,-7,12,-10,35,-3,0
2020,TX,12,121250,233853,367021,1,r,584149,279144,305005,844563,666252,178311,558146,177909,380237,844563,159057,172417,149171,112108,295728,97258,97724,100746,-9,20,15,9,-11,12,19,-7,12,-10,35,-3,0
2020,TX,13,50477,217124,273508,0,r,495640,252023,243617,714733,608357,106376,467927,99524,368403,714733,121874,132183,128333,114127,259762,118443,82620,58699,-9,20,15,9,-11,12,19,-7,12,-10,35,-3,0
2020,TX,14,118574,190541,309115,1,r,532061,266890,265171,760530,555583,204947,508033,127013,381020,760530,135597,145838,147595,109581,272741,101560,81823,89358,-9,20,15,9,-11,12,19,-7,12,-10,35,-3,0
2020,TX,15,115605,109017,228917,1,d,450561,225052,225509,804562,673951,130611,477484,101426,376058,804562,144130,151006,122614,94126,237783,123192,64259,50332,-9,20,15,9,-11,12,19,-7,12,-10,35,-3,0
2020,TX,16,154108,84006,238114,1,d,476360,238976,237384,747648,590426,157222,462367,113195,349172,747648,152554,133988,121518,92951,240099,121935,72729,45435,-9,20,15,9,-11,12,19,-7,12,-10,35,-3,0
2020,TX,17,125565,171390,306873,0,r,558009,274324,283685,786023,598086,187937,490759,158345,332414,786023,163887,144080,130236,100181,286608,123898,87196,75514,-9,20,15,9,-11,12,19,-7,12,-10,35,-3,0
2020,TX,18,180952,58033,246895,1,d,489098,238628,250470,827015,422157,404858,524100,120512,403588,827015,183689,162181,132105,82712,293472,150086,82680,60706,-9,20,15,9,-11,12,19,-7,12,-10,35,-3,0
2020,TX,19,60583,198198,265052,1,r,516199,256969,259230,729664,610334,119330,454185,108670,345515,729664,134928,129758,118878,105505,263521,119201,83895,60425,-9,20,15,9,-11,12,19,-7,12,-10,35,-3,0
2020,TX,2,148374,192828,346726,1,r,519981,258213,261768,787271,522787,264484,530472,236467,294005,787271,159446,162567,141351,100958,291668,85853,86014,119801,-9,20,15,9,-11,12,19,-7,12,-10,35,-3,0
2020,TX,20,175078,89628,270723,1,d,547526,266163,281363,832518,653853,178665,519014,127084,391930,832518,172375,159068,129573,97857,255836,117167,81301,57368,-9,20,15,9,-11,12,19,-7,12,-10,35,-3,0
2020,TX,21,205780,235740,453750,1,r,628280,303448,324832,829628,702484,127144,588657,278861,309796,829628,165558,163038,153135,142011,332269,107928,101980,122361,-9,20,15,9,-11,12,19,-7,12,-10,35,-3,0
2020,TX,22,181998,210259,408048,0,r,610720,294429,316291,960957,573797,387160,621482,282213,339269,960957,144911,218044,177887,108357,310680,68908,82699,159073,-9,20,15,9,-11,12,19,-7,12,-10,35,-3,0
2020,TX,23,137693,149395,295457,0,r,510863,258128,252735,786712,663333,123379,497841,118739,379102,786712,133994,152893,128535,103097,242400,103043,74979,64378,-9,20,15,9,-11,12,19,-7,12,-10,35,-3,0
2020,TX,24,163326,167910,344021,0,r,529495,259035,270460,832445,518092,314353,576087,278920,297167,832445,190503,179831,154255,90584,325176,92831,107321,125024,-9,20,15,9,-11,12,19,-7,12,-10,35,-3,0
2020,TX,25,165697,220088,393523,1,r,596070,297233,298837,818807,674846,143961,552026,224087,327939,818807,131650,170015,158607,115340,291833,89548,83419,118866,-9,20,15,9,-11,12,19,-7,12,-10,35,-3,0
2020,TX,26,161009,261963,432215,1,r,625355,298488,326867,920865,700197,220668,601745,274278,327467,920865,156180,203164,174993,99459,306921,65654,93551,147716,-9,20,15,9,-11,12,19,-7,12,-10,35,-3,0
2020,TX,27,95466,172305,273253,1,r,523961,253968,269993,745526,639102,106424,493133,99247,393886,745526,128687,135034,132196,124790,262779,118373,79574,64832,-9,20,15,9,-11,12,19,-7,12,-10,35,-3,0
2020,TX,28,137494,91925,235844,1,d,441163,216803,224360,772410,677177,95233,456304,91267,365037,772410,136432,139740,118656,92013,221494,103643,68910,48941,-9,20,15,9,-11,12,19,-7,12,-10,35,-3,0
2020,TX,29,111305,42840,156473,1,d,394689,192257,202432,783915,566071,217844,455705,52994,402711,783915,155845,149081,117762,68606,230537,119443,70859,40235,-9,20,15,9,-11,12,19,-7,12,-10,35,-3,0
2020,TX,3,179458,230512,418591,1,r,584690,280283,304407,913161,613332,299829,607497,330882,276615,913161,148192,215180,169175,105894,324907,78962,89968,155977,-9,20,15,9,-11,12,19,-7,12,-10,35,-3,0
2020,TX,30,204928,48685,264464,1,d,476002,222859,253143,792445,379301,413144,499610,111837,387773,792445,157303,148937,138956,86325,272334,130587,84105,57642,-9,20,15,9,-11,12,19,-7,12,-10,35,-3,0
2020,TX,31,176293,212695,397910,1,r,625582,308015,317567,916064,682987,233077,595333,216796,378537,916064,168888,195624,150260,112285,306854,94457,99421,112976,-9,20,15,9,-11,12,19,-7,12,-10,35,-3,0
2020,TX,32,178542,157867,343687,1,d,497892,243898,253994,778087,524069,254018,518219,234769,283450,778087,160190,150516,142495,99031,291460,90146,88115,113199,-9,20,15,9,-11,12,19,-7,12,-10,35,-3,0
2020,TX,33,105317,39638,157606,1,d,354913,172678,182235,751182,456809,294373,446498,58521,387977,751182,145380,147518,119493,63503,225078,120952,73154,30972,-9,20,15,9,-11,12,19,-7,12,-10,35,-3,0
2020,TX,34,111439,84119,201027,1,d,429232,213575,215657,712596,653713,58883,430752,66903,363849,712596,127668,122078,110809,102906,216930,122134,56370,38426,-9,20,15,9,-11,12,19,-7,12,-10,35,-3,0
2020,TX,35,176373,80795,269797,1,d,570039,282030,288009,857654,659727,197927,555491,139878,415613,857654,196113,174336,133894,90218,294971,135458,97677,61836,-9,20,15,9,-11,12,19,-7,12,-10,35,-3,0
2020,TX,36,73418,222712,302549,1,r,525600,258953,266647,758238,625107,133131,503083,97732,405351,758238,126284,145388,145795,109981,268143,104512,84057,79574,-9,20,15,9,-11,12,19,-7,12,-10,35,-3,0
2020,TX,4,76326,253837,336497,0,r,562550,272070,290480,782743,629311,153432,528010,124750,403260,782743,116987,149170,154202,130879,284355,116674,90414,77267,-9,20,15,9,-11,12,19,-7,12,-10,35,-3,0
2020,TX,5,100743,173836,280413,1,r,495961,243301,252660,759749,572437,187312,502646,99606,403040,759749,136497,146868,136878,112395,261420,114372,84404,62644,-9,20,15,9,-11,12,19,-7,12,-10,35,-3,0
2020,TX,6,149530,179507,339992,1,r,554164,263192,290972,818442,524922,293520,524526,169654,354872,818442,145075,162495,147973,100775,280492,92954,97206,90332,-9,20,15,9,-11,12,19,-7,12,-10,35,-3,0
2020,TX,7,159529,149054,314125,1,d,466858,222914,243944,762826,457317,305509,523483,263057,260426,762826,162535,166176,133194,89872,301869,99555,90345,111969,-9,20,15,9,-11,12,19,-7,12,-10,35,-3,0
2020,TX,8,97409,277327,382471,1,r,600690,305328,295362,895861,743993,151868,592960,180771,412189,895861,139849,182928,170990,128405,306739,102317,82162,122260,-9,20,15,9,-11,12,19,-7,12,-10,35,-3,0
2020,TX,9,172938,49575,229107,1,d,434566,209514,225052,769335,265600,503735,501591,132792,368799,769335,159795,158108,134863,86090,266557,135192,84004,47361,-9,20,15,9,-11,12,19,-7,12,-10,35,-3,0
2020,UT,1,104194,237988,342182,0,r,529838,266840,262998,787582,720006,67576,463729,147309,316420,787582,151662,150648,117227,83430,252011,76254,94811,80946,-9,20,15,9,-11,12,19,-7,12,-10,35,-3,0
2020,UT,2,129762,208997,354224,1,r,534997,267360,267637,788484,657266,131218,495711,159695,336016,788484,157225,148317,119997,110684,268916,90640,95168,83108,-9,20,15,9,-11,12,19,-7,12,-10,35,-3,0
2020,UT,3,96067,246674,358670,1,r,523751,259756,263995,779460,704050,75410,436665,183171,253494,779460,162783,135584,107989,86899,236363,69974,75957,90432,-9,20,15,9,-11,12,19,-7,12,-10,35,-3,0
2020,UT,4,175923,179688,376701,1,d,545663,271716,273947,850432,718205,132227,515487,174486,341001,850432,169225,173826,120650,84185,266565,70839,95011,100715,-9,20,15,9,-11,12,19,-7,12,-10,35,-3,0
2020,VA,1,186923,260614,447537,1,r,592356,292635,299721,824492,596921,227571,561779,212170,349609,824492,130332,164396,166447,129818,285625,73053,85802,126770,-9,20,15,9,-11,12,19,-7,12,-10,35,-3,0
2020,VA,10,268734,206253,474987,1,d,563408,278229,285179,857693,593061,264632,566571,320408,246163,857693,116368,192741,172029,110582,283522,41908,61756,179858,-9,20,15,9,-11,12,19,-7,12,-10,35,-3,0
2020,VA,11,280725,111380,392105,1,d,512022,250366,261656,789553,438131,351422,536615,306931,229684,789553,141700,172991,151673,99707,272568,48067,64644,159857,-9,20,15,9,-11,12,19,-7,12,-10,35,-3,0
2020,VA,2,185733,165031,359934,1,d,553005,273571,279434,723927,486553,237374,495348,186588,308760,723927,146109,132084,137584,113112,279179,87472,96762,94945,-9,20,15,9,-11,12,19,-7,12,-10,35,-3,0
2020,VA,3,233326,107299,340625,1,d,567916,268624,299292,760127,329198,430929,505749,134253,371496,760127,156155,138144,134602,108180,294139,129558,97444,67137,-9,20,15,9,-11,12,19,-7,12,-10,35,-3,0
2020,VA,4,241142,149625,390767,1,d,589257,283346,305911,768382,394028,374354,533621,164540,369081,768382,146246,147778,150580,119370,288854,119366,87690,81798,-9,20,15,9,-11,12,19,-7,12,-10,35,-3,0
2020,VA,5,190315,210988,401303,0,r,579655,276850,302805,735766,551428,184338,522039,151470,370569,735766,111414,126423,154171,154489,295095,128820,88321,77954,-9,20,15,9,-11,12,19,-7,12,-10,35,-3,0
2020,VA,6,134729,246606,381335,1,r,585724,281567,304157,755012,620342,134670,514320,145566,368754,755012,126033,132839,146300,141574,291647,120135,98507,73005,-9,20,15,9,-11,12,19,-7,12,-10,35,-3,0
2020,VA,7,230893,222623,453516,1,d,579534,278884,300650,802921,554096,248825,558123,226471,331652,802921,133435,159778,160370,132462,296638,89682,86606,120350,-9,20,15,9,-11,12,19,-7,12,-10,35,-3,0
2020,VA,8,301454,95365,396819,1,d,535969,264631,271338,813568,511900,301668,579951,367341,212610,813568,184679,184009,143195,100490,326597,63361,82621,180615,-9,20,15,9,-11,12,19,-7,12,-10,35,-3,0
2020,VA,9,0,0,0,1,r,567777,281461,286316,704078,638988,65090,498641,109332,389309,704078,102988,124914,146714,148552,277983,147092,83285,47606,-9,20,15,9,-11,12,19,-7,12,-10,35,-3,0
2020,VT,1,238827,95830,354295,1,d,498705,244340,254365,623989,585117,38872,445558,172272,273286,623989,98191,109916,133791,125201,262767,102245,85882,74640,-9,20,15,9,-11,12,19,-7,12,-10,35,-3,0
2020,WA,1,249944,176407,426351,1,d,533647,268887,264760,791545,594230,197315,551178,249721,301457,791545,136126,171340,158017,113113,288473,58621,77144,152708,-9,20,15,9,-11,12,19,-7,12,-10,35,-3,0
2020,WA,10,288977,0,288977,0,d,560905,276192,284713,770391,549123,221268,524814,146411,378403,770391,152553,148941,143225,115170,288727,91610,98067,99050,-9,20,15,9,-11,12,19,-7,12,-10,35,-3,0
2020,WA,2,255252,148384,403636,1,d,566650,277869,288781,760064,578055,182009,536360,179279,357081,760064,149137,145697,143985,131192,296423,91306,100613,104504,-9,20,15,9,-11,12,19,-7,12,-10,35,-3,0
2020,WA,3,181347,235579,416926,1,r,556214,274355,281859,756675,650254,106421,527220,143221,383999,756675,126118,143471,147540,136227,288096,98898,95065,94133,-9,20,15,9,-11,12,19,-7,12,-10,35,-3,0
2020,WA,4,102667,202108,304775,1,r,446137,219870,226267,735797,553564,182233,461394,102368,359026,735797,126312,132307,122894,106051,250101,103529,81271,65301,-9,20,15,9,-11,12,19,-7,12,-10,35,-3,0
2020,WA,5,155737,247815,403552,1,r,562834,277906,284928,734322,641200,93122,498036,151251,346785,734322,131234,129567,139062,128038,295592,127884,94310,73398,-9,20,15,9,-11,12,19,-7,12,-10,35,-3,0
2020,WA,6,247429,168783,416212,1,d,567917,282677,285240,726540,587323,139217,528520,174625,353895,726540,127390,130937,143016,154586,294537,96370,100036,98131,-9,20,15,9,-11,12,19,-7,12,-10,35,-3,0
2020,WA,7,387109,78240,465349,1,d,609219,303729,305490,817787,569986,247801,607880,378490,229390,817787,223888,175925,139245,108348,366275,92887,87049,186339,-9,20,15,9,-11,12,19,-7,12,-10,35,-3,0
2020,WA,8,213123,198423,411546,1,d,524468,261490,262978,770177,557905,212272,517771,190611,327160,770177,113155,164594,149433,110998,273857,66105,75931,131821,-9,20,15,9,-11,12,19,-7,12,-10,35,-3,0
2020,WA,9,258771,89697,348468,1,d,481044,241047,239997,751595,369451,382144,537151,239655,297496,751595,169743,152346,137079,103962,290396,79575,77678,133143,-9,20,15,9,-11,12,19,-7,12,-10,35,-3,0
2020,WI,1,163170,238271,401441,1,r,540501,266050,274451,721691,627038,94653,500882,152888,347994,721691,108344,139271,153481,124462,284862,102636,91462,90764,-9,20,15,9,-11,12,19,-7,12,-10,35,-3,0
2020,WI,2,318523,138306,456829,1,d,579336,283909,295427,773663,664613,109050,521266,234191,287075,773663,151900,148052,144385,118493,320423,107843,104366,108214,-9,20,15,9,-11,12,19,-7,12,-10,35,-3,0
2020,WI,3,199870,189524,389394,1,d,565661,283271,282390,723169,673955,49214,483418,130321,353097,723169,116731,124578,141896,133009,294067,121361,103964,68742,-9,20,15,9,-11,12,19,-7,12,-10,35,-3,0
2020,WI,4,232668,70769,311348,1,d,487730,229058,258672,704146,357357,346789,452496,132735,319761,704146,151650,127990,117972,84988,279444,145951,80849,52644,-9,20,15,9,-11,12,19,-7,12,-10,35,-3,0
2020,WI,5,175902,265434,441336,0,r,570227,278005,292222,733314,663623,69691,524502,200431,324071,733314,111817,137682,159092,140415,302776,91876,97182,113718,-9,20,15,9,-11,12,19,-7,12,-10,35,-3,0
2020,WI,6,164239,238874,403113,1,r,553146,276515,276631,715828,655759,60069,504312,142471,361841,715828,112012,131217,151470,136341,297909,113688,105719,78502,-9,20,15,9,-11,12,19,-7,12,-10,35,-3,0
2020,WI,7,162741,252048,414789,1,r,556088,278347,277741,714544,665940,48604,515418,125816,389602,714544,95660,128561,160786,150821,303088,124510,105639,72939,-9,20,15,9,-11,12,19,-7,12,-10,35,-3,0
2020,WI,8,149558,268173,417731,1,r,560199,277228,282971,736079,655069,81010,512991,139526,373465,736079,114792,136730,154908,131367,304054,115396,103372,85286,-9,20,15,9,-11,12,19,-7,12,-10,35,-3,0
2020,WV,1,81177,180488,261665,1,r,482965,239085,243880,601811,563410,38401,425766,99300,326466,601811,96861,110944,121112,121797,239559,115416,73625,50518,-9,20,15,9,-11,12,19,-7,12,-10,35,-3,0
2020,WV,2,100799,172195,272994,1,r,485281,236771,248510,623039,571968,51071,445446,100867,344579,623039,95396,117285,131074,121500,251318,119884,76589,54845,-9,20,15,9,-11,12,19,-7,12,-10,35,-3,0
2020,WV,3,64927,161585,226512,1,r,452043,220564,231479,567297,532626,34671,409874,69539,340335,567297,80415,105015,116987,124103,237298,136424,67020,33854,-9,20,15,9,-11,12,19,-7,12,-10,35,-3,0
2020,WY,1,66576,185732,270367,1,r,434852,220281,214571,578759,525860,52899,389847,113557,276290,578759,97297,105576,108833,98789,233128,84845,83185,65098,-9,20,15,9,-11,12,19,-7,12,-10,35,-3,0
